"","Year","Country Name","Indicator Name","Value","Month","Palestinians Killed","Israelis Killed","Poverty_Level","Total_Killed"
"1","2002","West Bank and Gaza","Population living in slums (% of urban population)",30,"AUGUST",53,13,"medium_poverty",66
"2","2002","West Bank and Gaza","Population living in slums (% of urban population)",30,"FEBRUARY",85,29,"medium_poverty",114
"3","2002","West Bank and Gaza","Population living in slums (% of urban population)",30,"JANUARY",28,16,"medium_poverty",44
"4","2002","West Bank and Gaza","Population living in slums (% of urban population)",30,"JUNE",57,57,"medium_poverty",114
"5","2002","West Bank and Gaza","Population living in slums (% of urban population)",30,"OCTOBER",66,22,"medium_poverty",88
"6","2002","West Bank and Gaza","Population living in slums (% of urban population)",30,"SEPTEMBER",51,13,"medium_poverty",64
"7","2002","West Bank and Gaza","Population living in slums (% of urban population)",30,"MARCH",237,122,"medium_poverty",359
"8","2002","West Bank and Gaza","Population living in slums (% of urban population)",30,"DECEMBER",72,7,"medium_poverty",79
"9","2002","West Bank and Gaza","Population living in slums (% of urban population)",30,"NOVEMBER",46,40,"medium_poverty",86
"10","2002","West Bank and Gaza","Population living in slums (% of urban population)",30,"MAY",48,29,"medium_poverty",77
"11","2002","West Bank and Gaza","Population living in slums (% of urban population)",30,"JULY",43,25,"medium_poverty",68
"12","2002","West Bank and Gaza","Population living in slums (% of urban population)",30,"APRIL",246,46,"medium_poverty",292
"13","2004","West Bank and Gaza","Population living in slums (% of urban population)",30,"JUNE",59,3,"medium_poverty",62
"14","2004","West Bank and Gaza","Population living in slums (% of urban population)",30,"DECEMBER",61,8,"medium_poverty",69
"15","2004","West Bank and Gaza","Population living in slums (% of urban population)",30,"AUGUST",39,17,"medium_poverty",56
"16","2004","West Bank and Gaza","Population living in slums (% of urban population)",30,"JULY",0,0,"medium_poverty",0
"17","2004","West Bank and Gaza","Population living in slums (% of urban population)",30,"APRIL",55,3,"medium_poverty",58
"18","2004","West Bank and Gaza","Population living in slums (% of urban population)",30,"MAY",113,19,"medium_poverty",132
"19","2004","West Bank and Gaza","Population living in slums (% of urban population)",30,"OCTOBER",145,3,"medium_poverty",148
"20","2004","West Bank and Gaza","Population living in slums (% of urban population)",30,"SEPTEMBER",112,11,"medium_poverty",123
"21","2004","West Bank and Gaza","Population living in slums (% of urban population)",30,"JANUARY",27,15,"medium_poverty",42
"22","2004","West Bank and Gaza","Population living in slums (% of urban population)",30,"FEBRUARY",54,11,"medium_poverty",65
"23","2004","West Bank and Gaza","Population living in slums (% of urban population)",30,"NOVEMBER",42,3,"medium_poverty",45
"24","2004","West Bank and Gaza","Population living in slums (% of urban population)",30,"MARCH",79,11,"medium_poverty",90
"25","2004","West Bank and Gaza","Income share held by lowest 10%",3,"JUNE",59,3,"high_poverty",62
"26","2004","West Bank and Gaza","Income share held by lowest 10%",3,"DECEMBER",61,8,"high_poverty",69
"27","2004","West Bank and Gaza","Income share held by lowest 10%",3,"AUGUST",39,17,"high_poverty",56
"28","2004","West Bank and Gaza","Income share held by lowest 10%",3,"JULY",0,0,"high_poverty",0
"29","2004","West Bank and Gaza","Income share held by lowest 10%",3,"APRIL",55,3,"high_poverty",58
"30","2004","West Bank and Gaza","Income share held by lowest 10%",3,"MAY",113,19,"high_poverty",132
"31","2004","West Bank and Gaza","Income share held by lowest 10%",3,"OCTOBER",145,3,"high_poverty",148
"32","2004","West Bank and Gaza","Income share held by lowest 10%",3,"SEPTEMBER",112,11,"high_poverty",123
"33","2004","West Bank and Gaza","Income share held by lowest 10%",3,"JANUARY",27,15,"high_poverty",42
"34","2004","West Bank and Gaza","Income share held by lowest 10%",3,"FEBRUARY",54,11,"high_poverty",65
"35","2004","West Bank and Gaza","Income share held by lowest 10%",3,"NOVEMBER",42,3,"high_poverty",45
"36","2004","West Bank and Gaza","Income share held by lowest 10%",3,"MARCH",79,11,"high_poverty",90
"37","2004","West Bank and Gaza","Poverty gap at $6.85 a day (2017 PPP) (%)",6,"JUNE",59,3,"high_poverty",62
"38","2004","West Bank and Gaza","Poverty gap at $6.85 a day (2017 PPP) (%)",6,"DECEMBER",61,8,"high_poverty",69
"39","2004","West Bank and Gaza","Poverty gap at $6.85 a day (2017 PPP) (%)",6,"AUGUST",39,17,"high_poverty",56
"40","2004","West Bank and Gaza","Poverty gap at $6.85 a day (2017 PPP) (%)",6,"JULY",0,0,"high_poverty",0
"41","2004","West Bank and Gaza","Poverty gap at $6.85 a day (2017 PPP) (%)",6,"APRIL",55,3,"high_poverty",58
"42","2004","West Bank and Gaza","Poverty gap at $6.85 a day (2017 PPP) (%)",6,"MAY",113,19,"high_poverty",132
"43","2004","West Bank and Gaza","Poverty gap at $6.85 a day (2017 PPP) (%)",6,"OCTOBER",145,3,"high_poverty",148
"44","2004","West Bank and Gaza","Poverty gap at $6.85 a day (2017 PPP) (%)",6,"SEPTEMBER",112,11,"high_poverty",123
"45","2004","West Bank and Gaza","Poverty gap at $6.85 a day (2017 PPP) (%)",6,"JANUARY",27,15,"high_poverty",42
"46","2004","West Bank and Gaza","Poverty gap at $6.85 a day (2017 PPP) (%)",6,"FEBRUARY",54,11,"high_poverty",65
"47","2004","West Bank and Gaza","Poverty gap at $6.85 a day (2017 PPP) (%)",6,"NOVEMBER",42,3,"high_poverty",45
"48","2004","West Bank and Gaza","Poverty gap at $6.85 a day (2017 PPP) (%)",6,"MARCH",79,11,"high_poverty",90
"49","2004","West Bank and Gaza","Income share held by lowest 20%",7.5,"JUNE",59,3,"high_poverty",62
"50","2004","West Bank and Gaza","Income share held by lowest 20%",7.5,"DECEMBER",61,8,"high_poverty",69
"51","2004","West Bank and Gaza","Income share held by lowest 20%",7.5,"AUGUST",39,17,"high_poverty",56
"52","2004","West Bank and Gaza","Income share held by lowest 20%",7.5,"JULY",0,0,"high_poverty",0
"53","2004","West Bank and Gaza","Income share held by lowest 20%",7.5,"APRIL",55,3,"high_poverty",58
"54","2004","West Bank and Gaza","Income share held by lowest 20%",7.5,"MAY",113,19,"high_poverty",132
"55","2004","West Bank and Gaza","Income share held by lowest 20%",7.5,"OCTOBER",145,3,"high_poverty",148
"56","2004","West Bank and Gaza","Income share held by lowest 20%",7.5,"SEPTEMBER",112,11,"high_poverty",123
"57","2004","West Bank and Gaza","Income share held by lowest 20%",7.5,"JANUARY",27,15,"high_poverty",42
"58","2004","West Bank and Gaza","Income share held by lowest 20%",7.5,"FEBRUARY",54,11,"high_poverty",65
"59","2004","West Bank and Gaza","Income share held by lowest 20%",7.5,"NOVEMBER",42,3,"high_poverty",45
"60","2004","West Bank and Gaza","Income share held by lowest 20%",7.5,"MARCH",79,11,"high_poverty",90
"61","2004","West Bank and Gaza","Income share held by second 20%",12,"JUNE",59,3,"medium_poverty",62
"62","2004","West Bank and Gaza","Income share held by second 20%",12,"DECEMBER",61,8,"medium_poverty",69
"63","2004","West Bank and Gaza","Income share held by second 20%",12,"AUGUST",39,17,"medium_poverty",56
"64","2004","West Bank and Gaza","Income share held by second 20%",12,"JULY",0,0,"medium_poverty",0
"65","2004","West Bank and Gaza","Income share held by second 20%",12,"APRIL",55,3,"medium_poverty",58
"66","2004","West Bank and Gaza","Income share held by second 20%",12,"MAY",113,19,"medium_poverty",132
"67","2004","West Bank and Gaza","Income share held by second 20%",12,"OCTOBER",145,3,"medium_poverty",148
"68","2004","West Bank and Gaza","Income share held by second 20%",12,"SEPTEMBER",112,11,"medium_poverty",123
"69","2004","West Bank and Gaza","Income share held by second 20%",12,"JANUARY",27,15,"medium_poverty",42
"70","2004","West Bank and Gaza","Income share held by second 20%",12,"FEBRUARY",54,11,"medium_poverty",65
"71","2004","West Bank and Gaza","Income share held by second 20%",12,"NOVEMBER",42,3,"medium_poverty",45
"72","2004","West Bank and Gaza","Income share held by second 20%",12,"MARCH",79,11,"medium_poverty",90
"73","2004","West Bank and Gaza","Proportion of people living below 50 percent of median income (%)",10.4,"JUNE",59,3,"medium_poverty",62
"74","2004","West Bank and Gaza","Proportion of people living below 50 percent of median income (%)",10.4,"DECEMBER",61,8,"medium_poverty",69
"75","2004","West Bank and Gaza","Proportion of people living below 50 percent of median income (%)",10.4,"AUGUST",39,17,"medium_poverty",56
"76","2004","West Bank and Gaza","Proportion of people living below 50 percent of median income (%)",10.4,"JULY",0,0,"medium_poverty",0
"77","2004","West Bank and Gaza","Proportion of people living below 50 percent of median income (%)",10.4,"APRIL",55,3,"medium_poverty",58
"78","2004","West Bank and Gaza","Proportion of people living below 50 percent of median income (%)",10.4,"MAY",113,19,"medium_poverty",132
"79","2004","West Bank and Gaza","Proportion of people living below 50 percent of median income (%)",10.4,"OCTOBER",145,3,"medium_poverty",148
"80","2004","West Bank and Gaza","Proportion of people living below 50 percent of median income (%)",10.4,"SEPTEMBER",112,11,"medium_poverty",123
"81","2004","West Bank and Gaza","Proportion of people living below 50 percent of median income (%)",10.4,"JANUARY",27,15,"medium_poverty",42
"82","2004","West Bank and Gaza","Proportion of people living below 50 percent of median income (%)",10.4,"FEBRUARY",54,11,"medium_poverty",65
"83","2004","West Bank and Gaza","Proportion of people living below 50 percent of median income (%)",10.4,"NOVEMBER",42,3,"medium_poverty",45
"84","2004","West Bank and Gaza","Proportion of people living below 50 percent of median income (%)",10.4,"MARCH",79,11,"medium_poverty",90
"85","2004","West Bank and Gaza","Income share held by highest 20%",41.8,"JUNE",59,3,"medium_poverty",62
"86","2004","West Bank and Gaza","Income share held by highest 20%",41.8,"DECEMBER",61,8,"medium_poverty",69
"87","2004","West Bank and Gaza","Income share held by highest 20%",41.8,"AUGUST",39,17,"medium_poverty",56
"88","2004","West Bank and Gaza","Income share held by highest 20%",41.8,"JULY",0,0,"medium_poverty",0
"89","2004","West Bank and Gaza","Income share held by highest 20%",41.8,"APRIL",55,3,"medium_poverty",58
"90","2004","West Bank and Gaza","Income share held by highest 20%",41.8,"MAY",113,19,"medium_poverty",132
"91","2004","West Bank and Gaza","Income share held by highest 20%",41.8,"OCTOBER",145,3,"medium_poverty",148
"92","2004","West Bank and Gaza","Income share held by highest 20%",41.8,"SEPTEMBER",112,11,"medium_poverty",123
"93","2004","West Bank and Gaza","Income share held by highest 20%",41.8,"JANUARY",27,15,"medium_poverty",42
"94","2004","West Bank and Gaza","Income share held by highest 20%",41.8,"FEBRUARY",54,11,"medium_poverty",65
"95","2004","West Bank and Gaza","Income share held by highest 20%",41.8,"NOVEMBER",42,3,"medium_poverty",45
"96","2004","West Bank and Gaza","Income share held by highest 20%",41.8,"MARCH",79,11,"medium_poverty",90
"97","2004","West Bank and Gaza","Income share held by third 20%",16.3,"JUNE",59,3,"medium_poverty",62
"98","2004","West Bank and Gaza","Income share held by third 20%",16.3,"DECEMBER",61,8,"medium_poverty",69
"99","2004","West Bank and Gaza","Income share held by third 20%",16.3,"AUGUST",39,17,"medium_poverty",56
"100","2004","West Bank and Gaza","Income share held by third 20%",16.3,"JULY",0,0,"medium_poverty",0
"101","2004","West Bank and Gaza","Income share held by third 20%",16.3,"APRIL",55,3,"medium_poverty",58
"102","2004","West Bank and Gaza","Income share held by third 20%",16.3,"MAY",113,19,"medium_poverty",132
"103","2004","West Bank and Gaza","Income share held by third 20%",16.3,"OCTOBER",145,3,"medium_poverty",148
"104","2004","West Bank and Gaza","Income share held by third 20%",16.3,"SEPTEMBER",112,11,"medium_poverty",123
"105","2004","West Bank and Gaza","Income share held by third 20%",16.3,"JANUARY",27,15,"medium_poverty",42
"106","2004","West Bank and Gaza","Income share held by third 20%",16.3,"FEBRUARY",54,11,"medium_poverty",65
"107","2004","West Bank and Gaza","Income share held by third 20%",16.3,"NOVEMBER",42,3,"medium_poverty",45
"108","2004","West Bank and Gaza","Income share held by third 20%",16.3,"MARCH",79,11,"medium_poverty",90
"109","2004","West Bank and Gaza","Income share held by highest 10%",26.5,"JUNE",59,3,"medium_poverty",62
"110","2004","West Bank and Gaza","Income share held by highest 10%",26.5,"DECEMBER",61,8,"medium_poverty",69
"111","2004","West Bank and Gaza","Income share held by highest 10%",26.5,"AUGUST",39,17,"medium_poverty",56
"112","2004","West Bank and Gaza","Income share held by highest 10%",26.5,"JULY",0,0,"medium_poverty",0
"113","2004","West Bank and Gaza","Income share held by highest 10%",26.5,"APRIL",55,3,"medium_poverty",58
"114","2004","West Bank and Gaza","Income share held by highest 10%",26.5,"MAY",113,19,"medium_poverty",132
"115","2004","West Bank and Gaza","Income share held by highest 10%",26.5,"OCTOBER",145,3,"medium_poverty",148
"116","2004","West Bank and Gaza","Income share held by highest 10%",26.5,"SEPTEMBER",112,11,"medium_poverty",123
"117","2004","West Bank and Gaza","Income share held by highest 10%",26.5,"JANUARY",27,15,"medium_poverty",42
"118","2004","West Bank and Gaza","Income share held by highest 10%",26.5,"FEBRUARY",54,11,"medium_poverty",65
"119","2004","West Bank and Gaza","Income share held by highest 10%",26.5,"NOVEMBER",42,3,"medium_poverty",45
"120","2004","West Bank and Gaza","Income share held by highest 10%",26.5,"MARCH",79,11,"medium_poverty",90
"121","2004","West Bank and Gaza","Income share held by fourth 20%",22.4,"JUNE",59,3,"medium_poverty",62
"122","2004","West Bank and Gaza","Income share held by fourth 20%",22.4,"DECEMBER",61,8,"medium_poverty",69
"123","2004","West Bank and Gaza","Income share held by fourth 20%",22.4,"AUGUST",39,17,"medium_poverty",56
"124","2004","West Bank and Gaza","Income share held by fourth 20%",22.4,"JULY",0,0,"medium_poverty",0
"125","2004","West Bank and Gaza","Income share held by fourth 20%",22.4,"APRIL",55,3,"medium_poverty",58
"126","2004","West Bank and Gaza","Income share held by fourth 20%",22.4,"MAY",113,19,"medium_poverty",132
"127","2004","West Bank and Gaza","Income share held by fourth 20%",22.4,"OCTOBER",145,3,"medium_poverty",148
"128","2004","West Bank and Gaza","Income share held by fourth 20%",22.4,"SEPTEMBER",112,11,"medium_poverty",123
"129","2004","West Bank and Gaza","Income share held by fourth 20%",22.4,"JANUARY",27,15,"medium_poverty",42
"130","2004","West Bank and Gaza","Income share held by fourth 20%",22.4,"FEBRUARY",54,11,"medium_poverty",65
"131","2004","West Bank and Gaza","Income share held by fourth 20%",22.4,"NOVEMBER",42,3,"medium_poverty",45
"132","2004","West Bank and Gaza","Income share held by fourth 20%",22.4,"MARCH",79,11,"medium_poverty",90
"133","2004","West Bank and Gaza","Gini index",34,"JUNE",59,3,"medium_poverty",62
"134","2004","West Bank and Gaza","Gini index",34,"DECEMBER",61,8,"medium_poverty",69
"135","2004","West Bank and Gaza","Gini index",34,"AUGUST",39,17,"medium_poverty",56
"136","2004","West Bank and Gaza","Gini index",34,"JULY",0,0,"medium_poverty",0
"137","2004","West Bank and Gaza","Gini index",34,"APRIL",55,3,"medium_poverty",58
"138","2004","West Bank and Gaza","Gini index",34,"MAY",113,19,"medium_poverty",132
"139","2004","West Bank and Gaza","Gini index",34,"OCTOBER",145,3,"medium_poverty",148
"140","2004","West Bank and Gaza","Gini index",34,"SEPTEMBER",112,11,"medium_poverty",123
"141","2004","West Bank and Gaza","Gini index",34,"JANUARY",27,15,"medium_poverty",42
"142","2004","West Bank and Gaza","Gini index",34,"FEBRUARY",54,11,"medium_poverty",65
"143","2004","West Bank and Gaza","Gini index",34,"NOVEMBER",42,3,"medium_poverty",45
"144","2004","West Bank and Gaza","Gini index",34,"MARCH",79,11,"medium_poverty",90
"145","2004","West Bank and Gaza","Poverty headcount ratio at $2.15 a day (2017 PPP) (% of population)",0.6,"JUNE",59,3,"high_poverty",62
"146","2004","West Bank and Gaza","Poverty headcount ratio at $2.15 a day (2017 PPP) (% of population)",0.6,"DECEMBER",61,8,"high_poverty",69
"147","2004","West Bank and Gaza","Poverty headcount ratio at $2.15 a day (2017 PPP) (% of population)",0.6,"AUGUST",39,17,"high_poverty",56
"148","2004","West Bank and Gaza","Poverty headcount ratio at $2.15 a day (2017 PPP) (% of population)",0.6,"JULY",0,0,"high_poverty",0
"149","2004","West Bank and Gaza","Poverty headcount ratio at $2.15 a day (2017 PPP) (% of population)",0.6,"APRIL",55,3,"high_poverty",58
"150","2004","West Bank and Gaza","Poverty headcount ratio at $2.15 a day (2017 PPP) (% of population)",0.6,"MAY",113,19,"high_poverty",132
"151","2004","West Bank and Gaza","Poverty headcount ratio at $2.15 a day (2017 PPP) (% of population)",0.6,"OCTOBER",145,3,"high_poverty",148
"152","2004","West Bank and Gaza","Poverty headcount ratio at $2.15 a day (2017 PPP) (% of population)",0.6,"SEPTEMBER",112,11,"high_poverty",123
"153","2004","West Bank and Gaza","Poverty headcount ratio at $2.15 a day (2017 PPP) (% of population)",0.6,"JANUARY",27,15,"high_poverty",42
"154","2004","West Bank and Gaza","Poverty headcount ratio at $2.15 a day (2017 PPP) (% of population)",0.6,"FEBRUARY",54,11,"high_poverty",65
"155","2004","West Bank and Gaza","Poverty headcount ratio at $2.15 a day (2017 PPP) (% of population)",0.6,"NOVEMBER",42,3,"high_poverty",45
"156","2004","West Bank and Gaza","Poverty headcount ratio at $2.15 a day (2017 PPP) (% of population)",0.6,"MARCH",79,11,"high_poverty",90
"157","2004","West Bank and Gaza","Poverty headcount ratio at $3.65 a day (2017 PPP) (% of population)",3.6,"JUNE",59,3,"high_poverty",62
"158","2004","West Bank and Gaza","Poverty headcount ratio at $3.65 a day (2017 PPP) (% of population)",3.6,"DECEMBER",61,8,"high_poverty",69
"159","2004","West Bank and Gaza","Poverty headcount ratio at $3.65 a day (2017 PPP) (% of population)",3.6,"AUGUST",39,17,"high_poverty",56
"160","2004","West Bank and Gaza","Poverty headcount ratio at $3.65 a day (2017 PPP) (% of population)",3.6,"JULY",0,0,"high_poverty",0
"161","2004","West Bank and Gaza","Poverty headcount ratio at $3.65 a day (2017 PPP) (% of population)",3.6,"APRIL",55,3,"high_poverty",58
"162","2004","West Bank and Gaza","Poverty headcount ratio at $3.65 a day (2017 PPP) (% of population)",3.6,"MAY",113,19,"high_poverty",132
"163","2004","West Bank and Gaza","Poverty headcount ratio at $3.65 a day (2017 PPP) (% of population)",3.6,"OCTOBER",145,3,"high_poverty",148
"164","2004","West Bank and Gaza","Poverty headcount ratio at $3.65 a day (2017 PPP) (% of population)",3.6,"SEPTEMBER",112,11,"high_poverty",123
"165","2004","West Bank and Gaza","Poverty headcount ratio at $3.65 a day (2017 PPP) (% of population)",3.6,"JANUARY",27,15,"high_poverty",42
"166","2004","West Bank and Gaza","Poverty headcount ratio at $3.65 a day (2017 PPP) (% of population)",3.6,"FEBRUARY",54,11,"high_poverty",65
"167","2004","West Bank and Gaza","Poverty headcount ratio at $3.65 a day (2017 PPP) (% of population)",3.6,"NOVEMBER",42,3,"high_poverty",45
"168","2004","West Bank and Gaza","Poverty headcount ratio at $3.65 a day (2017 PPP) (% of population)",3.6,"MARCH",79,11,"high_poverty",90
"169","2004","West Bank and Gaza","Poverty gap at $2.15 a day (2017 PPP) (%)",0.1,"JUNE",59,3,"high_poverty",62
"170","2004","West Bank and Gaza","Poverty gap at $2.15 a day (2017 PPP) (%)",0.1,"DECEMBER",61,8,"high_poverty",69
"171","2004","West Bank and Gaza","Poverty gap at $2.15 a day (2017 PPP) (%)",0.1,"AUGUST",39,17,"high_poverty",56
"172","2004","West Bank and Gaza","Poverty gap at $2.15 a day (2017 PPP) (%)",0.1,"JULY",0,0,"high_poverty",0
"173","2004","West Bank and Gaza","Poverty gap at $2.15 a day (2017 PPP) (%)",0.1,"APRIL",55,3,"high_poverty",58
"174","2004","West Bank and Gaza","Poverty gap at $2.15 a day (2017 PPP) (%)",0.1,"MAY",113,19,"high_poverty",132
"175","2004","West Bank and Gaza","Poverty gap at $2.15 a day (2017 PPP) (%)",0.1,"OCTOBER",145,3,"high_poverty",148
"176","2004","West Bank and Gaza","Poverty gap at $2.15 a day (2017 PPP) (%)",0.1,"SEPTEMBER",112,11,"high_poverty",123
"177","2004","West Bank and Gaza","Poverty gap at $2.15 a day (2017 PPP) (%)",0.1,"JANUARY",27,15,"high_poverty",42
"178","2004","West Bank and Gaza","Poverty gap at $2.15 a day (2017 PPP) (%)",0.1,"FEBRUARY",54,11,"high_poverty",65
"179","2004","West Bank and Gaza","Poverty gap at $2.15 a day (2017 PPP) (%)",0.1,"NOVEMBER",42,3,"high_poverty",45
"180","2004","West Bank and Gaza","Poverty gap at $2.15 a day (2017 PPP) (%)",0.1,"MARCH",79,11,"high_poverty",90
"181","2004","West Bank and Gaza","Poverty headcount ratio at $6.85 a day (2017 PPP) (% of population)",23.6,"JUNE",59,3,"high_poverty",62
"182","2004","West Bank and Gaza","Poverty headcount ratio at $6.85 a day (2017 PPP) (% of population)",23.6,"DECEMBER",61,8,"high_poverty",69
"183","2004","West Bank and Gaza","Poverty headcount ratio at $6.85 a day (2017 PPP) (% of population)",23.6,"AUGUST",39,17,"high_poverty",56
"184","2004","West Bank and Gaza","Poverty headcount ratio at $6.85 a day (2017 PPP) (% of population)",23.6,"JULY",0,0,"high_poverty",0
"185","2004","West Bank and Gaza","Poverty headcount ratio at $6.85 a day (2017 PPP) (% of population)",23.6,"APRIL",55,3,"high_poverty",58
"186","2004","West Bank and Gaza","Poverty headcount ratio at $6.85 a day (2017 PPP) (% of population)",23.6,"MAY",113,19,"high_poverty",132
"187","2004","West Bank and Gaza","Poverty headcount ratio at $6.85 a day (2017 PPP) (% of population)",23.6,"OCTOBER",145,3,"high_poverty",148
"188","2004","West Bank and Gaza","Poverty headcount ratio at $6.85 a day (2017 PPP) (% of population)",23.6,"SEPTEMBER",112,11,"high_poverty",123
"189","2004","West Bank and Gaza","Poverty headcount ratio at $6.85 a day (2017 PPP) (% of population)",23.6,"JANUARY",27,15,"high_poverty",42
"190","2004","West Bank and Gaza","Poverty headcount ratio at $6.85 a day (2017 PPP) (% of population)",23.6,"FEBRUARY",54,11,"high_poverty",65
"191","2004","West Bank and Gaza","Poverty headcount ratio at $6.85 a day (2017 PPP) (% of population)",23.6,"NOVEMBER",42,3,"high_poverty",45
"192","2004","West Bank and Gaza","Poverty headcount ratio at $6.85 a day (2017 PPP) (% of population)",23.6,"MARCH",79,11,"high_poverty",90
"193","2004","West Bank and Gaza","Poverty gap at $3.65 a day (2017 PPP) (%)",0.9,"JUNE",59,3,"high_poverty",62
"194","2004","West Bank and Gaza","Poverty gap at $3.65 a day (2017 PPP) (%)",0.9,"DECEMBER",61,8,"high_poverty",69
"195","2004","West Bank and Gaza","Poverty gap at $3.65 a day (2017 PPP) (%)",0.9,"AUGUST",39,17,"high_poverty",56
"196","2004","West Bank and Gaza","Poverty gap at $3.65 a day (2017 PPP) (%)",0.9,"JULY",0,0,"high_poverty",0
"197","2004","West Bank and Gaza","Poverty gap at $3.65 a day (2017 PPP) (%)",0.9,"APRIL",55,3,"high_poverty",58
"198","2004","West Bank and Gaza","Poverty gap at $3.65 a day (2017 PPP) (%)",0.9,"MAY",113,19,"high_poverty",132
"199","2004","West Bank and Gaza","Poverty gap at $3.65 a day (2017 PPP) (%)",0.9,"OCTOBER",145,3,"high_poverty",148
"200","2004","West Bank and Gaza","Poverty gap at $3.65 a day (2017 PPP) (%)",0.9,"SEPTEMBER",112,11,"high_poverty",123
"201","2004","West Bank and Gaza","Poverty gap at $3.65 a day (2017 PPP) (%)",0.9,"JANUARY",27,15,"high_poverty",42
"202","2004","West Bank and Gaza","Poverty gap at $3.65 a day (2017 PPP) (%)",0.9,"FEBRUARY",54,11,"high_poverty",65
"203","2004","West Bank and Gaza","Poverty gap at $3.65 a day (2017 PPP) (%)",0.9,"NOVEMBER",42,3,"high_poverty",45
"204","2004","West Bank and Gaza","Poverty gap at $3.65 a day (2017 PPP) (%)",0.9,"MARCH",79,11,"high_poverty",90
"205","2005","West Bank and Gaza","Proportion of people living below 50 percent of median income (%)",11.8,"NOVEMBER",15,1,"medium_poverty",16
"206","2005","West Bank and Gaza","Proportion of people living below 50 percent of median income (%)",11.8,"OCTOBER",22,10,"medium_poverty",32
"207","2005","West Bank and Gaza","Proportion of people living below 50 percent of median income (%)",11.8,"SEPTEMBER",17,1,"medium_poverty",18
"208","2005","West Bank and Gaza","Proportion of people living below 50 percent of median income (%)",11.8,"DECEMBER",20,8,"medium_poverty",28
"209","2005","West Bank and Gaza","Proportion of people living below 50 percent of median income (%)",11.8,"JULY",25,8,"medium_poverty",33
"210","2005","West Bank and Gaza","Proportion of people living below 50 percent of median income (%)",11.8,"JUNE",5,4,"medium_poverty",9
"211","2005","West Bank and Gaza","Proportion of people living below 50 percent of median income (%)",11.8,"MAY",10,1,"medium_poverty",11
"212","2005","West Bank and Gaza","Proportion of people living below 50 percent of median income (%)",11.8,"AUGUST",11,0,"medium_poverty",11
"213","2005","West Bank and Gaza","Proportion of people living below 50 percent of median income (%)",11.8,"MARCH",1,0,"medium_poverty",1
"214","2005","West Bank and Gaza","Proportion of people living below 50 percent of median income (%)",11.8,"FEBRUARY",9,5,"medium_poverty",14
"215","2005","West Bank and Gaza","Proportion of people living below 50 percent of median income (%)",11.8,"JANUARY",50,13,"medium_poverty",63
"216","2005","West Bank and Gaza","Proportion of people living below 50 percent of median income (%)",11.8,"APRIL",5,0,"medium_poverty",5
"217","2005","West Bank and Gaza","Income share held by third 20%",16.1,"NOVEMBER",15,1,"medium_poverty",16
"218","2005","West Bank and Gaza","Income share held by third 20%",16.1,"OCTOBER",22,10,"medium_poverty",32
"219","2005","West Bank and Gaza","Income share held by third 20%",16.1,"SEPTEMBER",17,1,"medium_poverty",18
"220","2005","West Bank and Gaza","Income share held by third 20%",16.1,"DECEMBER",20,8,"medium_poverty",28
"221","2005","West Bank and Gaza","Income share held by third 20%",16.1,"JULY",25,8,"medium_poverty",33
"222","2005","West Bank and Gaza","Income share held by third 20%",16.1,"JUNE",5,4,"medium_poverty",9
"223","2005","West Bank and Gaza","Income share held by third 20%",16.1,"MAY",10,1,"medium_poverty",11
"224","2005","West Bank and Gaza","Income share held by third 20%",16.1,"AUGUST",11,0,"medium_poverty",11
"225","2005","West Bank and Gaza","Income share held by third 20%",16.1,"MARCH",1,0,"medium_poverty",1
"226","2005","West Bank and Gaza","Income share held by third 20%",16.1,"FEBRUARY",9,5,"medium_poverty",14
"227","2005","West Bank and Gaza","Income share held by third 20%",16.1,"JANUARY",50,13,"medium_poverty",63
"228","2005","West Bank and Gaza","Income share held by third 20%",16.1,"APRIL",5,0,"medium_poverty",5
"229","2005","West Bank and Gaza","Poverty headcount ratio at $3.65 a day (2017 PPP) (% of population)",3.2,"NOVEMBER",15,1,"high_poverty",16
"230","2005","West Bank and Gaza","Poverty headcount ratio at $3.65 a day (2017 PPP) (% of population)",3.2,"OCTOBER",22,10,"high_poverty",32
"231","2005","West Bank and Gaza","Poverty headcount ratio at $3.65 a day (2017 PPP) (% of population)",3.2,"SEPTEMBER",17,1,"high_poverty",18
"232","2005","West Bank and Gaza","Poverty headcount ratio at $3.65 a day (2017 PPP) (% of population)",3.2,"DECEMBER",20,8,"high_poverty",28
"233","2005","West Bank and Gaza","Poverty headcount ratio at $3.65 a day (2017 PPP) (% of population)",3.2,"JULY",25,8,"high_poverty",33
"234","2005","West Bank and Gaza","Poverty headcount ratio at $3.65 a day (2017 PPP) (% of population)",3.2,"JUNE",5,4,"high_poverty",9
"235","2005","West Bank and Gaza","Poverty headcount ratio at $3.65 a day (2017 PPP) (% of population)",3.2,"MAY",10,1,"high_poverty",11
"236","2005","West Bank and Gaza","Poverty headcount ratio at $3.65 a day (2017 PPP) (% of population)",3.2,"AUGUST",11,0,"high_poverty",11
"237","2005","West Bank and Gaza","Poverty headcount ratio at $3.65 a day (2017 PPP) (% of population)",3.2,"MARCH",1,0,"high_poverty",1
"238","2005","West Bank and Gaza","Poverty headcount ratio at $3.65 a day (2017 PPP) (% of population)",3.2,"FEBRUARY",9,5,"high_poverty",14
"239","2005","West Bank and Gaza","Poverty headcount ratio at $3.65 a day (2017 PPP) (% of population)",3.2,"JANUARY",50,13,"high_poverty",63
"240","2005","West Bank and Gaza","Poverty headcount ratio at $3.65 a day (2017 PPP) (% of population)",3.2,"APRIL",5,0,"high_poverty",5
"241","2005","West Bank and Gaza","Income share held by fourth 20%",22.5,"NOVEMBER",15,1,"medium_poverty",16
"242","2005","West Bank and Gaza","Income share held by fourth 20%",22.5,"OCTOBER",22,10,"medium_poverty",32
"243","2005","West Bank and Gaza","Income share held by fourth 20%",22.5,"SEPTEMBER",17,1,"medium_poverty",18
"244","2005","West Bank and Gaza","Income share held by fourth 20%",22.5,"DECEMBER",20,8,"medium_poverty",28
"245","2005","West Bank and Gaza","Income share held by fourth 20%",22.5,"JULY",25,8,"medium_poverty",33
"246","2005","West Bank and Gaza","Income share held by fourth 20%",22.5,"JUNE",5,4,"medium_poverty",9
"247","2005","West Bank and Gaza","Income share held by fourth 20%",22.5,"MAY",10,1,"medium_poverty",11
"248","2005","West Bank and Gaza","Income share held by fourth 20%",22.5,"AUGUST",11,0,"medium_poverty",11
"249","2005","West Bank and Gaza","Income share held by fourth 20%",22.5,"MARCH",1,0,"medium_poverty",1
"250","2005","West Bank and Gaza","Income share held by fourth 20%",22.5,"FEBRUARY",9,5,"medium_poverty",14
"251","2005","West Bank and Gaza","Income share held by fourth 20%",22.5,"JANUARY",50,13,"medium_poverty",63
"252","2005","West Bank and Gaza","Income share held by fourth 20%",22.5,"APRIL",5,0,"medium_poverty",5
"253","2005","West Bank and Gaza","Income share held by highest 20%",42.3,"NOVEMBER",15,1,"medium_poverty",16
"254","2005","West Bank and Gaza","Income share held by highest 20%",42.3,"OCTOBER",22,10,"medium_poverty",32
"255","2005","West Bank and Gaza","Income share held by highest 20%",42.3,"SEPTEMBER",17,1,"medium_poverty",18
"256","2005","West Bank and Gaza","Income share held by highest 20%",42.3,"DECEMBER",20,8,"medium_poverty",28
"257","2005","West Bank and Gaza","Income share held by highest 20%",42.3,"JULY",25,8,"medium_poverty",33
"258","2005","West Bank and Gaza","Income share held by highest 20%",42.3,"JUNE",5,4,"medium_poverty",9
"259","2005","West Bank and Gaza","Income share held by highest 20%",42.3,"MAY",10,1,"medium_poverty",11
"260","2005","West Bank and Gaza","Income share held by highest 20%",42.3,"AUGUST",11,0,"medium_poverty",11
"261","2005","West Bank and Gaza","Income share held by highest 20%",42.3,"MARCH",1,0,"medium_poverty",1
"262","2005","West Bank and Gaza","Income share held by highest 20%",42.3,"FEBRUARY",9,5,"medium_poverty",14
"263","2005","West Bank and Gaza","Income share held by highest 20%",42.3,"JANUARY",50,13,"medium_poverty",63
"264","2005","West Bank and Gaza","Income share held by highest 20%",42.3,"APRIL",5,0,"medium_poverty",5
"265","2005","West Bank and Gaza","Poverty headcount ratio at $2.15 a day (2017 PPP) (% of population)",0.2,"NOVEMBER",15,1,"high_poverty",16
"266","2005","West Bank and Gaza","Poverty headcount ratio at $2.15 a day (2017 PPP) (% of population)",0.2,"OCTOBER",22,10,"high_poverty",32
"267","2005","West Bank and Gaza","Poverty headcount ratio at $2.15 a day (2017 PPP) (% of population)",0.2,"SEPTEMBER",17,1,"high_poverty",18
"268","2005","West Bank and Gaza","Poverty headcount ratio at $2.15 a day (2017 PPP) (% of population)",0.2,"DECEMBER",20,8,"high_poverty",28
"269","2005","West Bank and Gaza","Poverty headcount ratio at $2.15 a day (2017 PPP) (% of population)",0.2,"JULY",25,8,"high_poverty",33
"270","2005","West Bank and Gaza","Poverty headcount ratio at $2.15 a day (2017 PPP) (% of population)",0.2,"JUNE",5,4,"high_poverty",9
"271","2005","West Bank and Gaza","Poverty headcount ratio at $2.15 a day (2017 PPP) (% of population)",0.2,"MAY",10,1,"high_poverty",11
"272","2005","West Bank and Gaza","Poverty headcount ratio at $2.15 a day (2017 PPP) (% of population)",0.2,"AUGUST",11,0,"high_poverty",11
"273","2005","West Bank and Gaza","Poverty headcount ratio at $2.15 a day (2017 PPP) (% of population)",0.2,"MARCH",1,0,"high_poverty",1
"274","2005","West Bank and Gaza","Poverty headcount ratio at $2.15 a day (2017 PPP) (% of population)",0.2,"FEBRUARY",9,5,"high_poverty",14
"275","2005","West Bank and Gaza","Poverty headcount ratio at $2.15 a day (2017 PPP) (% of population)",0.2,"JANUARY",50,13,"high_poverty",63
"276","2005","West Bank and Gaza","Poverty headcount ratio at $2.15 a day (2017 PPP) (% of population)",0.2,"APRIL",5,0,"high_poverty",5
"277","2005","West Bank and Gaza","Income share held by second 20%",11.8,"NOVEMBER",15,1,"medium_poverty",16
"278","2005","West Bank and Gaza","Income share held by second 20%",11.8,"OCTOBER",22,10,"medium_poverty",32
"279","2005","West Bank and Gaza","Income share held by second 20%",11.8,"SEPTEMBER",17,1,"medium_poverty",18
"280","2005","West Bank and Gaza","Income share held by second 20%",11.8,"DECEMBER",20,8,"medium_poverty",28
"281","2005","West Bank and Gaza","Income share held by second 20%",11.8,"JULY",25,8,"medium_poverty",33
"282","2005","West Bank and Gaza","Income share held by second 20%",11.8,"JUNE",5,4,"medium_poverty",9
"283","2005","West Bank and Gaza","Income share held by second 20%",11.8,"MAY",10,1,"medium_poverty",11
"284","2005","West Bank and Gaza","Income share held by second 20%",11.8,"AUGUST",11,0,"medium_poverty",11
"285","2005","West Bank and Gaza","Income share held by second 20%",11.8,"MARCH",1,0,"medium_poverty",1
"286","2005","West Bank and Gaza","Income share held by second 20%",11.8,"FEBRUARY",9,5,"medium_poverty",14
"287","2005","West Bank and Gaza","Income share held by second 20%",11.8,"JANUARY",50,13,"medium_poverty",63
"288","2005","West Bank and Gaza","Income share held by second 20%",11.8,"APRIL",5,0,"medium_poverty",5
"289","2005","West Bank and Gaza","Income share held by highest 10%",26.7,"NOVEMBER",15,1,"medium_poverty",16
"290","2005","West Bank and Gaza","Income share held by highest 10%",26.7,"OCTOBER",22,10,"medium_poverty",32
"291","2005","West Bank and Gaza","Income share held by highest 10%",26.7,"SEPTEMBER",17,1,"medium_poverty",18
"292","2005","West Bank and Gaza","Income share held by highest 10%",26.7,"DECEMBER",20,8,"medium_poverty",28
"293","2005","West Bank and Gaza","Income share held by highest 10%",26.7,"JULY",25,8,"medium_poverty",33
"294","2005","West Bank and Gaza","Income share held by highest 10%",26.7,"JUNE",5,4,"medium_poverty",9
"295","2005","West Bank and Gaza","Income share held by highest 10%",26.7,"MAY",10,1,"medium_poverty",11
"296","2005","West Bank and Gaza","Income share held by highest 10%",26.7,"AUGUST",11,0,"medium_poverty",11
"297","2005","West Bank and Gaza","Income share held by highest 10%",26.7,"MARCH",1,0,"medium_poverty",1
"298","2005","West Bank and Gaza","Income share held by highest 10%",26.7,"FEBRUARY",9,5,"medium_poverty",14
"299","2005","West Bank and Gaza","Income share held by highest 10%",26.7,"JANUARY",50,13,"medium_poverty",63
"300","2005","West Bank and Gaza","Income share held by highest 10%",26.7,"APRIL",5,0,"medium_poverty",5
"301","2005","West Bank and Gaza","Gini index",34.7,"NOVEMBER",15,1,"medium_poverty",16
"302","2005","West Bank and Gaza","Gini index",34.7,"OCTOBER",22,10,"medium_poverty",32
"303","2005","West Bank and Gaza","Gini index",34.7,"SEPTEMBER",17,1,"medium_poverty",18
"304","2005","West Bank and Gaza","Gini index",34.7,"DECEMBER",20,8,"medium_poverty",28
"305","2005","West Bank and Gaza","Gini index",34.7,"JULY",25,8,"medium_poverty",33
"306","2005","West Bank and Gaza","Gini index",34.7,"JUNE",5,4,"medium_poverty",9
"307","2005","West Bank and Gaza","Gini index",34.7,"MAY",10,1,"medium_poverty",11
"308","2005","West Bank and Gaza","Gini index",34.7,"AUGUST",11,0,"medium_poverty",11
"309","2005","West Bank and Gaza","Gini index",34.7,"MARCH",1,0,"medium_poverty",1
"310","2005","West Bank and Gaza","Gini index",34.7,"FEBRUARY",9,5,"medium_poverty",14
"311","2005","West Bank and Gaza","Gini index",34.7,"JANUARY",50,13,"medium_poverty",63
"312","2005","West Bank and Gaza","Gini index",34.7,"APRIL",5,0,"medium_poverty",5
"313","2005","West Bank and Gaza","Income share held by lowest 20%",7.3,"NOVEMBER",15,1,"high_poverty",16
"314","2005","West Bank and Gaza","Income share held by lowest 20%",7.3,"OCTOBER",22,10,"high_poverty",32
"315","2005","West Bank and Gaza","Income share held by lowest 20%",7.3,"SEPTEMBER",17,1,"high_poverty",18
"316","2005","West Bank and Gaza","Income share held by lowest 20%",7.3,"DECEMBER",20,8,"high_poverty",28
"317","2005","West Bank and Gaza","Income share held by lowest 20%",7.3,"JULY",25,8,"high_poverty",33
"318","2005","West Bank and Gaza","Income share held by lowest 20%",7.3,"JUNE",5,4,"high_poverty",9
"319","2005","West Bank and Gaza","Income share held by lowest 20%",7.3,"MAY",10,1,"high_poverty",11
"320","2005","West Bank and Gaza","Income share held by lowest 20%",7.3,"AUGUST",11,0,"high_poverty",11
"321","2005","West Bank and Gaza","Income share held by lowest 20%",7.3,"MARCH",1,0,"high_poverty",1
"322","2005","West Bank and Gaza","Income share held by lowest 20%",7.3,"FEBRUARY",9,5,"high_poverty",14
"323","2005","West Bank and Gaza","Income share held by lowest 20%",7.3,"JANUARY",50,13,"high_poverty",63
"324","2005","West Bank and Gaza","Income share held by lowest 20%",7.3,"APRIL",5,0,"high_poverty",5
"325","2005","West Bank and Gaza","Poverty gap at $3.65 a day (2017 PPP) (%)",0.6,"NOVEMBER",15,1,"high_poverty",16
"326","2005","West Bank and Gaza","Poverty gap at $3.65 a day (2017 PPP) (%)",0.6,"OCTOBER",22,10,"high_poverty",32
"327","2005","West Bank and Gaza","Poverty gap at $3.65 a day (2017 PPP) (%)",0.6,"SEPTEMBER",17,1,"high_poverty",18
"328","2005","West Bank and Gaza","Poverty gap at $3.65 a day (2017 PPP) (%)",0.6,"DECEMBER",20,8,"high_poverty",28
"329","2005","West Bank and Gaza","Poverty gap at $3.65 a day (2017 PPP) (%)",0.6,"JULY",25,8,"high_poverty",33
"330","2005","West Bank and Gaza","Poverty gap at $3.65 a day (2017 PPP) (%)",0.6,"JUNE",5,4,"high_poverty",9
"331","2005","West Bank and Gaza","Poverty gap at $3.65 a day (2017 PPP) (%)",0.6,"MAY",10,1,"high_poverty",11
"332","2005","West Bank and Gaza","Poverty gap at $3.65 a day (2017 PPP) (%)",0.6,"AUGUST",11,0,"high_poverty",11
"333","2005","West Bank and Gaza","Poverty gap at $3.65 a day (2017 PPP) (%)",0.6,"MARCH",1,0,"high_poverty",1
"334","2005","West Bank and Gaza","Poverty gap at $3.65 a day (2017 PPP) (%)",0.6,"FEBRUARY",9,5,"high_poverty",14
"335","2005","West Bank and Gaza","Poverty gap at $3.65 a day (2017 PPP) (%)",0.6,"JANUARY",50,13,"high_poverty",63
"336","2005","West Bank and Gaza","Poverty gap at $3.65 a day (2017 PPP) (%)",0.6,"APRIL",5,0,"high_poverty",5
"337","2005","West Bank and Gaza","Poverty gap at $6.85 a day (2017 PPP) (%)",5.7,"NOVEMBER",15,1,"high_poverty",16
"338","2005","West Bank and Gaza","Poverty gap at $6.85 a day (2017 PPP) (%)",5.7,"OCTOBER",22,10,"high_poverty",32
"339","2005","West Bank and Gaza","Poverty gap at $6.85 a day (2017 PPP) (%)",5.7,"SEPTEMBER",17,1,"high_poverty",18
"340","2005","West Bank and Gaza","Poverty gap at $6.85 a day (2017 PPP) (%)",5.7,"DECEMBER",20,8,"high_poverty",28
"341","2005","West Bank and Gaza","Poverty gap at $6.85 a day (2017 PPP) (%)",5.7,"JULY",25,8,"high_poverty",33
"342","2005","West Bank and Gaza","Poverty gap at $6.85 a day (2017 PPP) (%)",5.7,"JUNE",5,4,"high_poverty",9
"343","2005","West Bank and Gaza","Poverty gap at $6.85 a day (2017 PPP) (%)",5.7,"MAY",10,1,"high_poverty",11
"344","2005","West Bank and Gaza","Poverty gap at $6.85 a day (2017 PPP) (%)",5.7,"AUGUST",11,0,"high_poverty",11
"345","2005","West Bank and Gaza","Poverty gap at $6.85 a day (2017 PPP) (%)",5.7,"MARCH",1,0,"high_poverty",1
"346","2005","West Bank and Gaza","Poverty gap at $6.85 a day (2017 PPP) (%)",5.7,"FEBRUARY",9,5,"high_poverty",14
"347","2005","West Bank and Gaza","Poverty gap at $6.85 a day (2017 PPP) (%)",5.7,"JANUARY",50,13,"high_poverty",63
"348","2005","West Bank and Gaza","Poverty gap at $6.85 a day (2017 PPP) (%)",5.7,"APRIL",5,0,"high_poverty",5
"349","2005","West Bank and Gaza","Poverty headcount ratio at $6.85 a day (2017 PPP) (% of population)",21.5,"NOVEMBER",15,1,"high_poverty",16
"350","2005","West Bank and Gaza","Poverty headcount ratio at $6.85 a day (2017 PPP) (% of population)",21.5,"OCTOBER",22,10,"high_poverty",32
"351","2005","West Bank and Gaza","Poverty headcount ratio at $6.85 a day (2017 PPP) (% of population)",21.5,"SEPTEMBER",17,1,"high_poverty",18
"352","2005","West Bank and Gaza","Poverty headcount ratio at $6.85 a day (2017 PPP) (% of population)",21.5,"DECEMBER",20,8,"high_poverty",28
"353","2005","West Bank and Gaza","Poverty headcount ratio at $6.85 a day (2017 PPP) (% of population)",21.5,"JULY",25,8,"high_poverty",33
"354","2005","West Bank and Gaza","Poverty headcount ratio at $6.85 a day (2017 PPP) (% of population)",21.5,"JUNE",5,4,"high_poverty",9
"355","2005","West Bank and Gaza","Poverty headcount ratio at $6.85 a day (2017 PPP) (% of population)",21.5,"MAY",10,1,"high_poverty",11
"356","2005","West Bank and Gaza","Poverty headcount ratio at $6.85 a day (2017 PPP) (% of population)",21.5,"AUGUST",11,0,"high_poverty",11
"357","2005","West Bank and Gaza","Poverty headcount ratio at $6.85 a day (2017 PPP) (% of population)",21.5,"MARCH",1,0,"high_poverty",1
"358","2005","West Bank and Gaza","Poverty headcount ratio at $6.85 a day (2017 PPP) (% of population)",21.5,"FEBRUARY",9,5,"high_poverty",14
"359","2005","West Bank and Gaza","Poverty headcount ratio at $6.85 a day (2017 PPP) (% of population)",21.5,"JANUARY",50,13,"high_poverty",63
"360","2005","West Bank and Gaza","Poverty headcount ratio at $6.85 a day (2017 PPP) (% of population)",21.5,"APRIL",5,0,"high_poverty",5
"361","2005","West Bank and Gaza","Poverty gap at $2.15 a day (2017 PPP) (%)",0,"NOVEMBER",15,1,"high_poverty",16
"362","2005","West Bank and Gaza","Poverty gap at $2.15 a day (2017 PPP) (%)",0,"OCTOBER",22,10,"high_poverty",32
"363","2005","West Bank and Gaza","Poverty gap at $2.15 a day (2017 PPP) (%)",0,"SEPTEMBER",17,1,"high_poverty",18
"364","2005","West Bank and Gaza","Poverty gap at $2.15 a day (2017 PPP) (%)",0,"DECEMBER",20,8,"high_poverty",28
"365","2005","West Bank and Gaza","Poverty gap at $2.15 a day (2017 PPP) (%)",0,"JULY",25,8,"high_poverty",33
"366","2005","West Bank and Gaza","Poverty gap at $2.15 a day (2017 PPP) (%)",0,"JUNE",5,4,"high_poverty",9
"367","2005","West Bank and Gaza","Poverty gap at $2.15 a day (2017 PPP) (%)",0,"MAY",10,1,"high_poverty",11
"368","2005","West Bank and Gaza","Poverty gap at $2.15 a day (2017 PPP) (%)",0,"AUGUST",11,0,"high_poverty",11
"369","2005","West Bank and Gaza","Poverty gap at $2.15 a day (2017 PPP) (%)",0,"MARCH",1,0,"high_poverty",1
"370","2005","West Bank and Gaza","Poverty gap at $2.15 a day (2017 PPP) (%)",0,"FEBRUARY",9,5,"high_poverty",14
"371","2005","West Bank and Gaza","Poverty gap at $2.15 a day (2017 PPP) (%)",0,"JANUARY",50,13,"high_poverty",63
"372","2005","West Bank and Gaza","Poverty gap at $2.15 a day (2017 PPP) (%)",0,"APRIL",5,0,"high_poverty",5
"373","2005","West Bank and Gaza","Income share held by lowest 10%",2.9,"NOVEMBER",15,1,"high_poverty",16
"374","2005","West Bank and Gaza","Income share held by lowest 10%",2.9,"OCTOBER",22,10,"high_poverty",32
"375","2005","West Bank and Gaza","Income share held by lowest 10%",2.9,"SEPTEMBER",17,1,"high_poverty",18
"376","2005","West Bank and Gaza","Income share held by lowest 10%",2.9,"DECEMBER",20,8,"high_poverty",28
"377","2005","West Bank and Gaza","Income share held by lowest 10%",2.9,"JULY",25,8,"high_poverty",33
"378","2005","West Bank and Gaza","Income share held by lowest 10%",2.9,"JUNE",5,4,"high_poverty",9
"379","2005","West Bank and Gaza","Income share held by lowest 10%",2.9,"MAY",10,1,"high_poverty",11
"380","2005","West Bank and Gaza","Income share held by lowest 10%",2.9,"AUGUST",11,0,"high_poverty",11
"381","2005","West Bank and Gaza","Income share held by lowest 10%",2.9,"MARCH",1,0,"high_poverty",1
"382","2005","West Bank and Gaza","Income share held by lowest 10%",2.9,"FEBRUARY",9,5,"high_poverty",14
"383","2005","West Bank and Gaza","Income share held by lowest 10%",2.9,"JANUARY",50,13,"high_poverty",63
"384","2005","West Bank and Gaza","Income share held by lowest 10%",2.9,"APRIL",5,0,"high_poverty",5
"385","2006","West Bank and Gaza","Income share held by highest 10%",27.1,"APRIL",31,7,"medium_poverty",38
"386","2006","West Bank and Gaza","Income share held by highest 10%",27.1,"JUNE",43,3,"medium_poverty",46
"387","2006","West Bank and Gaza","Income share held by highest 10%",27.1,"MAY",37,0,"medium_poverty",37
"388","2006","West Bank and Gaza","Income share held by highest 10%",27.1,"FEBRUARY",31,1,"medium_poverty",32
"389","2006","West Bank and Gaza","Income share held by highest 10%",27.1,"NOVEMBER",134,0,"medium_poverty",134
"390","2006","West Bank and Gaza","Income share held by highest 10%",27.1,"OCTOBER",61,0,"medium_poverty",61
"391","2006","West Bank and Gaza","Income share held by highest 10%",27.1,"SEPTEMBER",32,1,"medium_poverty",33
"392","2006","West Bank and Gaza","Income share held by highest 10%",27.1,"AUGUST",74,1,"medium_poverty",75
"393","2006","West Bank and Gaza","Income share held by highest 10%",27.1,"JULY",180,2,"medium_poverty",182
"394","2006","West Bank and Gaza","Income share held by highest 10%",27.1,"MARCH",15,5,"medium_poverty",20
"395","2006","West Bank and Gaza","Income share held by highest 10%",27.1,"DECEMBER",14,0,"medium_poverty",14
"396","2006","West Bank and Gaza","Income share held by highest 10%",27.1,"JANUARY",13,0,"medium_poverty",13
"397","2006","West Bank and Gaza","Proportion of people living below 50 percent of median income (%)",10,"APRIL",31,7,"medium_poverty",38
"398","2006","West Bank and Gaza","Proportion of people living below 50 percent of median income (%)",10,"JUNE",43,3,"medium_poverty",46
"399","2006","West Bank and Gaza","Proportion of people living below 50 percent of median income (%)",10,"MAY",37,0,"medium_poverty",37
"400","2006","West Bank and Gaza","Proportion of people living below 50 percent of median income (%)",10,"FEBRUARY",31,1,"medium_poverty",32
"401","2006","West Bank and Gaza","Proportion of people living below 50 percent of median income (%)",10,"NOVEMBER",134,0,"medium_poverty",134
"402","2006","West Bank and Gaza","Proportion of people living below 50 percent of median income (%)",10,"OCTOBER",61,0,"medium_poverty",61
"403","2006","West Bank and Gaza","Proportion of people living below 50 percent of median income (%)",10,"SEPTEMBER",32,1,"medium_poverty",33
"404","2006","West Bank and Gaza","Proportion of people living below 50 percent of median income (%)",10,"AUGUST",74,1,"medium_poverty",75
"405","2006","West Bank and Gaza","Proportion of people living below 50 percent of median income (%)",10,"JULY",180,2,"medium_poverty",182
"406","2006","West Bank and Gaza","Proportion of people living below 50 percent of median income (%)",10,"MARCH",15,5,"medium_poverty",20
"407","2006","West Bank and Gaza","Proportion of people living below 50 percent of median income (%)",10,"DECEMBER",14,0,"medium_poverty",14
"408","2006","West Bank and Gaza","Proportion of people living below 50 percent of median income (%)",10,"JANUARY",13,0,"medium_poverty",13
"409","2006","West Bank and Gaza","Income share held by highest 20%",42.2,"APRIL",31,7,"medium_poverty",38
"410","2006","West Bank and Gaza","Income share held by highest 20%",42.2,"JUNE",43,3,"medium_poverty",46
"411","2006","West Bank and Gaza","Income share held by highest 20%",42.2,"MAY",37,0,"medium_poverty",37
"412","2006","West Bank and Gaza","Income share held by highest 20%",42.2,"FEBRUARY",31,1,"medium_poverty",32
"413","2006","West Bank and Gaza","Income share held by highest 20%",42.2,"NOVEMBER",134,0,"medium_poverty",134
"414","2006","West Bank and Gaza","Income share held by highest 20%",42.2,"OCTOBER",61,0,"medium_poverty",61
"415","2006","West Bank and Gaza","Income share held by highest 20%",42.2,"SEPTEMBER",32,1,"medium_poverty",33
"416","2006","West Bank and Gaza","Income share held by highest 20%",42.2,"AUGUST",74,1,"medium_poverty",75
"417","2006","West Bank and Gaza","Income share held by highest 20%",42.2,"JULY",180,2,"medium_poverty",182
"418","2006","West Bank and Gaza","Income share held by highest 20%",42.2,"MARCH",15,5,"medium_poverty",20
"419","2006","West Bank and Gaza","Income share held by highest 20%",42.2,"DECEMBER",14,0,"medium_poverty",14
"420","2006","West Bank and Gaza","Income share held by highest 20%",42.2,"JANUARY",13,0,"medium_poverty",13
"421","2006","West Bank and Gaza","Poverty headcount ratio at $6.85 a day (2017 PPP) (% of population)",19.7,"APRIL",31,7,"high_poverty",38
"422","2006","West Bank and Gaza","Poverty headcount ratio at $6.85 a day (2017 PPP) (% of population)",19.7,"JUNE",43,3,"high_poverty",46
"423","2006","West Bank and Gaza","Poverty headcount ratio at $6.85 a day (2017 PPP) (% of population)",19.7,"MAY",37,0,"high_poverty",37
"424","2006","West Bank and Gaza","Poverty headcount ratio at $6.85 a day (2017 PPP) (% of population)",19.7,"FEBRUARY",31,1,"high_poverty",32
"425","2006","West Bank and Gaza","Poverty headcount ratio at $6.85 a day (2017 PPP) (% of population)",19.7,"NOVEMBER",134,0,"high_poverty",134
"426","2006","West Bank and Gaza","Poverty headcount ratio at $6.85 a day (2017 PPP) (% of population)",19.7,"OCTOBER",61,0,"high_poverty",61
"427","2006","West Bank and Gaza","Poverty headcount ratio at $6.85 a day (2017 PPP) (% of population)",19.7,"SEPTEMBER",32,1,"high_poverty",33
"428","2006","West Bank and Gaza","Poverty headcount ratio at $6.85 a day (2017 PPP) (% of population)",19.7,"AUGUST",74,1,"high_poverty",75
"429","2006","West Bank and Gaza","Poverty headcount ratio at $6.85 a day (2017 PPP) (% of population)",19.7,"JULY",180,2,"high_poverty",182
"430","2006","West Bank and Gaza","Poverty headcount ratio at $6.85 a day (2017 PPP) (% of population)",19.7,"MARCH",15,5,"high_poverty",20
"431","2006","West Bank and Gaza","Poverty headcount ratio at $6.85 a day (2017 PPP) (% of population)",19.7,"DECEMBER",14,0,"high_poverty",14
"432","2006","West Bank and Gaza","Poverty headcount ratio at $6.85 a day (2017 PPP) (% of population)",19.7,"JANUARY",13,0,"high_poverty",13
"433","2006","West Bank and Gaza","Poverty gap at $3.65 a day (2017 PPP) (%)",0.3,"APRIL",31,7,"high_poverty",38
"434","2006","West Bank and Gaza","Poverty gap at $3.65 a day (2017 PPP) (%)",0.3,"JUNE",43,3,"high_poverty",46
"435","2006","West Bank and Gaza","Poverty gap at $3.65 a day (2017 PPP) (%)",0.3,"MAY",37,0,"high_poverty",37
"436","2006","West Bank and Gaza","Poverty gap at $3.65 a day (2017 PPP) (%)",0.3,"FEBRUARY",31,1,"high_poverty",32
"437","2006","West Bank and Gaza","Poverty gap at $3.65 a day (2017 PPP) (%)",0.3,"NOVEMBER",134,0,"high_poverty",134
"438","2006","West Bank and Gaza","Poverty gap at $3.65 a day (2017 PPP) (%)",0.3,"OCTOBER",61,0,"high_poverty",61
"439","2006","West Bank and Gaza","Poverty gap at $3.65 a day (2017 PPP) (%)",0.3,"SEPTEMBER",32,1,"high_poverty",33
"440","2006","West Bank and Gaza","Poverty gap at $3.65 a day (2017 PPP) (%)",0.3,"AUGUST",74,1,"high_poverty",75
"441","2006","West Bank and Gaza","Poverty gap at $3.65 a day (2017 PPP) (%)",0.3,"JULY",180,2,"high_poverty",182
"442","2006","West Bank and Gaza","Poverty gap at $3.65 a day (2017 PPP) (%)",0.3,"MARCH",15,5,"high_poverty",20
"443","2006","West Bank and Gaza","Poverty gap at $3.65 a day (2017 PPP) (%)",0.3,"DECEMBER",14,0,"high_poverty",14
"444","2006","West Bank and Gaza","Poverty gap at $3.65 a day (2017 PPP) (%)",0.3,"JANUARY",13,0,"high_poverty",13
"445","2006","West Bank and Gaza","Income share held by fourth 20%",21.8,"APRIL",31,7,"medium_poverty",38
"446","2006","West Bank and Gaza","Income share held by fourth 20%",21.8,"JUNE",43,3,"medium_poverty",46
"447","2006","West Bank and Gaza","Income share held by fourth 20%",21.8,"MAY",37,0,"medium_poverty",37
"448","2006","West Bank and Gaza","Income share held by fourth 20%",21.8,"FEBRUARY",31,1,"medium_poverty",32
"449","2006","West Bank and Gaza","Income share held by fourth 20%",21.8,"NOVEMBER",134,0,"medium_poverty",134
"450","2006","West Bank and Gaza","Income share held by fourth 20%",21.8,"OCTOBER",61,0,"medium_poverty",61
"451","2006","West Bank and Gaza","Income share held by fourth 20%",21.8,"SEPTEMBER",32,1,"medium_poverty",33
"452","2006","West Bank and Gaza","Income share held by fourth 20%",21.8,"AUGUST",74,1,"medium_poverty",75
"453","2006","West Bank and Gaza","Income share held by fourth 20%",21.8,"JULY",180,2,"medium_poverty",182
"454","2006","West Bank and Gaza","Income share held by fourth 20%",21.8,"MARCH",15,5,"medium_poverty",20
"455","2006","West Bank and Gaza","Income share held by fourth 20%",21.8,"DECEMBER",14,0,"medium_poverty",14
"456","2006","West Bank and Gaza","Income share held by fourth 20%",21.8,"JANUARY",13,0,"medium_poverty",13
"457","2006","West Bank and Gaza","Population living in slums (% of urban population)",29.07112,"APRIL",31,7,"medium_poverty",38
"458","2006","West Bank and Gaza","Population living in slums (% of urban population)",29.07112,"JUNE",43,3,"medium_poverty",46
"459","2006","West Bank and Gaza","Population living in slums (% of urban population)",29.07112,"MAY",37,0,"medium_poverty",37
"460","2006","West Bank and Gaza","Population living in slums (% of urban population)",29.07112,"FEBRUARY",31,1,"medium_poverty",32
"461","2006","West Bank and Gaza","Population living in slums (% of urban population)",29.07112,"NOVEMBER",134,0,"medium_poverty",134
"462","2006","West Bank and Gaza","Population living in slums (% of urban population)",29.07112,"OCTOBER",61,0,"medium_poverty",61
"463","2006","West Bank and Gaza","Population living in slums (% of urban population)",29.07112,"SEPTEMBER",32,1,"medium_poverty",33
"464","2006","West Bank and Gaza","Population living in slums (% of urban population)",29.07112,"AUGUST",74,1,"medium_poverty",75
"465","2006","West Bank and Gaza","Population living in slums (% of urban population)",29.07112,"JULY",180,2,"medium_poverty",182
"466","2006","West Bank and Gaza","Population living in slums (% of urban population)",29.07112,"MARCH",15,5,"medium_poverty",20
"467","2006","West Bank and Gaza","Population living in slums (% of urban population)",29.07112,"DECEMBER",14,0,"medium_poverty",14
"468","2006","West Bank and Gaza","Population living in slums (% of urban population)",29.07112,"JANUARY",13,0,"medium_poverty",13
"469","2006","West Bank and Gaza","Income share held by second 20%",12.1,"APRIL",31,7,"medium_poverty",38
"470","2006","West Bank and Gaza","Income share held by second 20%",12.1,"JUNE",43,3,"medium_poverty",46
"471","2006","West Bank and Gaza","Income share held by second 20%",12.1,"MAY",37,0,"medium_poverty",37
"472","2006","West Bank and Gaza","Income share held by second 20%",12.1,"FEBRUARY",31,1,"medium_poverty",32
"473","2006","West Bank and Gaza","Income share held by second 20%",12.1,"NOVEMBER",134,0,"medium_poverty",134
"474","2006","West Bank and Gaza","Income share held by second 20%",12.1,"OCTOBER",61,0,"medium_poverty",61
"475","2006","West Bank and Gaza","Income share held by second 20%",12.1,"SEPTEMBER",32,1,"medium_poverty",33
"476","2006","West Bank and Gaza","Income share held by second 20%",12.1,"AUGUST",74,1,"medium_poverty",75
"477","2006","West Bank and Gaza","Income share held by second 20%",12.1,"JULY",180,2,"medium_poverty",182
"478","2006","West Bank and Gaza","Income share held by second 20%",12.1,"MARCH",15,5,"medium_poverty",20
"479","2006","West Bank and Gaza","Income share held by second 20%",12.1,"DECEMBER",14,0,"medium_poverty",14
"480","2006","West Bank and Gaza","Income share held by second 20%",12.1,"JANUARY",13,0,"medium_poverty",13
"481","2006","West Bank and Gaza","Income share held by lowest 10%",3.2,"APRIL",31,7,"high_poverty",38
"482","2006","West Bank and Gaza","Income share held by lowest 10%",3.2,"JUNE",43,3,"high_poverty",46
"483","2006","West Bank and Gaza","Income share held by lowest 10%",3.2,"MAY",37,0,"high_poverty",37
"484","2006","West Bank and Gaza","Income share held by lowest 10%",3.2,"FEBRUARY",31,1,"high_poverty",32
"485","2006","West Bank and Gaza","Income share held by lowest 10%",3.2,"NOVEMBER",134,0,"high_poverty",134
"486","2006","West Bank and Gaza","Income share held by lowest 10%",3.2,"OCTOBER",61,0,"high_poverty",61
"487","2006","West Bank and Gaza","Income share held by lowest 10%",3.2,"SEPTEMBER",32,1,"high_poverty",33
"488","2006","West Bank and Gaza","Income share held by lowest 10%",3.2,"AUGUST",74,1,"high_poverty",75
"489","2006","West Bank and Gaza","Income share held by lowest 10%",3.2,"JULY",180,2,"high_poverty",182
"490","2006","West Bank and Gaza","Income share held by lowest 10%",3.2,"MARCH",15,5,"high_poverty",20
"491","2006","West Bank and Gaza","Income share held by lowest 10%",3.2,"DECEMBER",14,0,"high_poverty",14
"492","2006","West Bank and Gaza","Income share held by lowest 10%",3.2,"JANUARY",13,0,"high_poverty",13
"493","2006","West Bank and Gaza","Poverty headcount ratio at $3.65 a day (2017 PPP) (% of population)",2,"APRIL",31,7,"high_poverty",38
"494","2006","West Bank and Gaza","Poverty headcount ratio at $3.65 a day (2017 PPP) (% of population)",2,"JUNE",43,3,"high_poverty",46
"495","2006","West Bank and Gaza","Poverty headcount ratio at $3.65 a day (2017 PPP) (% of population)",2,"MAY",37,0,"high_poverty",37
"496","2006","West Bank and Gaza","Poverty headcount ratio at $3.65 a day (2017 PPP) (% of population)",2,"FEBRUARY",31,1,"high_poverty",32
"497","2006","West Bank and Gaza","Poverty headcount ratio at $3.65 a day (2017 PPP) (% of population)",2,"NOVEMBER",134,0,"high_poverty",134
"498","2006","West Bank and Gaza","Poverty headcount ratio at $3.65 a day (2017 PPP) (% of population)",2,"OCTOBER",61,0,"high_poverty",61
"499","2006","West Bank and Gaza","Poverty headcount ratio at $3.65 a day (2017 PPP) (% of population)",2,"SEPTEMBER",32,1,"high_poverty",33
"500","2006","West Bank and Gaza","Poverty headcount ratio at $3.65 a day (2017 PPP) (% of population)",2,"AUGUST",74,1,"high_poverty",75
"501","2006","West Bank and Gaza","Poverty headcount ratio at $3.65 a day (2017 PPP) (% of population)",2,"JULY",180,2,"high_poverty",182
"502","2006","West Bank and Gaza","Poverty headcount ratio at $3.65 a day (2017 PPP) (% of population)",2,"MARCH",15,5,"high_poverty",20
"503","2006","West Bank and Gaza","Poverty headcount ratio at $3.65 a day (2017 PPP) (% of population)",2,"DECEMBER",14,0,"high_poverty",14
"504","2006","West Bank and Gaza","Poverty headcount ratio at $3.65 a day (2017 PPP) (% of population)",2,"JANUARY",13,0,"high_poverty",13
"505","2006","West Bank and Gaza","Poverty gap at $6.85 a day (2017 PPP) (%)",4.7,"APRIL",31,7,"high_poverty",38
"506","2006","West Bank and Gaza","Poverty gap at $6.85 a day (2017 PPP) (%)",4.7,"JUNE",43,3,"high_poverty",46
"507","2006","West Bank and Gaza","Poverty gap at $6.85 a day (2017 PPP) (%)",4.7,"MAY",37,0,"high_poverty",37
"508","2006","West Bank and Gaza","Poverty gap at $6.85 a day (2017 PPP) (%)",4.7,"FEBRUARY",31,1,"high_poverty",32
"509","2006","West Bank and Gaza","Poverty gap at $6.85 a day (2017 PPP) (%)",4.7,"NOVEMBER",134,0,"high_poverty",134
"510","2006","West Bank and Gaza","Poverty gap at $6.85 a day (2017 PPP) (%)",4.7,"OCTOBER",61,0,"high_poverty",61
"511","2006","West Bank and Gaza","Poverty gap at $6.85 a day (2017 PPP) (%)",4.7,"SEPTEMBER",32,1,"high_poverty",33
"512","2006","West Bank and Gaza","Poverty gap at $6.85 a day (2017 PPP) (%)",4.7,"AUGUST",74,1,"high_poverty",75
"513","2006","West Bank and Gaza","Poverty gap at $6.85 a day (2017 PPP) (%)",4.7,"JULY",180,2,"high_poverty",182
"514","2006","West Bank and Gaza","Poverty gap at $6.85 a day (2017 PPP) (%)",4.7,"MARCH",15,5,"high_poverty",20
"515","2006","West Bank and Gaza","Poverty gap at $6.85 a day (2017 PPP) (%)",4.7,"DECEMBER",14,0,"high_poverty",14
"516","2006","West Bank and Gaza","Poverty gap at $6.85 a day (2017 PPP) (%)",4.7,"JANUARY",13,0,"high_poverty",13
"517","2006","West Bank and Gaza","Income share held by lowest 20%",7.8,"APRIL",31,7,"high_poverty",38
"518","2006","West Bank and Gaza","Income share held by lowest 20%",7.8,"JUNE",43,3,"high_poverty",46
"519","2006","West Bank and Gaza","Income share held by lowest 20%",7.8,"MAY",37,0,"high_poverty",37
"520","2006","West Bank and Gaza","Income share held by lowest 20%",7.8,"FEBRUARY",31,1,"high_poverty",32
"521","2006","West Bank and Gaza","Income share held by lowest 20%",7.8,"NOVEMBER",134,0,"high_poverty",134
"522","2006","West Bank and Gaza","Income share held by lowest 20%",7.8,"OCTOBER",61,0,"high_poverty",61
"523","2006","West Bank and Gaza","Income share held by lowest 20%",7.8,"SEPTEMBER",32,1,"high_poverty",33
"524","2006","West Bank and Gaza","Income share held by lowest 20%",7.8,"AUGUST",74,1,"high_poverty",75
"525","2006","West Bank and Gaza","Income share held by lowest 20%",7.8,"JULY",180,2,"high_poverty",182
"526","2006","West Bank and Gaza","Income share held by lowest 20%",7.8,"MARCH",15,5,"high_poverty",20
"527","2006","West Bank and Gaza","Income share held by lowest 20%",7.8,"DECEMBER",14,0,"high_poverty",14
"528","2006","West Bank and Gaza","Income share held by lowest 20%",7.8,"JANUARY",13,0,"high_poverty",13
"529","2006","West Bank and Gaza","Gini index",34,"APRIL",31,7,"medium_poverty",38
"530","2006","West Bank and Gaza","Gini index",34,"JUNE",43,3,"medium_poverty",46
"531","2006","West Bank and Gaza","Gini index",34,"MAY",37,0,"medium_poverty",37
"532","2006","West Bank and Gaza","Gini index",34,"FEBRUARY",31,1,"medium_poverty",32
"533","2006","West Bank and Gaza","Gini index",34,"NOVEMBER",134,0,"medium_poverty",134
"534","2006","West Bank and Gaza","Gini index",34,"OCTOBER",61,0,"medium_poverty",61
"535","2006","West Bank and Gaza","Gini index",34,"SEPTEMBER",32,1,"medium_poverty",33
"536","2006","West Bank and Gaza","Gini index",34,"AUGUST",74,1,"medium_poverty",75
"537","2006","West Bank and Gaza","Gini index",34,"JULY",180,2,"medium_poverty",182
"538","2006","West Bank and Gaza","Gini index",34,"MARCH",15,5,"medium_poverty",20
"539","2006","West Bank and Gaza","Gini index",34,"DECEMBER",14,0,"medium_poverty",14
"540","2006","West Bank and Gaza","Gini index",34,"JANUARY",13,0,"medium_poverty",13
"541","2006","West Bank and Gaza","Income share held by third 20%",16.1,"APRIL",31,7,"medium_poverty",38
"542","2006","West Bank and Gaza","Income share held by third 20%",16.1,"JUNE",43,3,"medium_poverty",46
"543","2006","West Bank and Gaza","Income share held by third 20%",16.1,"MAY",37,0,"medium_poverty",37
"544","2006","West Bank and Gaza","Income share held by third 20%",16.1,"FEBRUARY",31,1,"medium_poverty",32
"545","2006","West Bank and Gaza","Income share held by third 20%",16.1,"NOVEMBER",134,0,"medium_poverty",134
"546","2006","West Bank and Gaza","Income share held by third 20%",16.1,"OCTOBER",61,0,"medium_poverty",61
"547","2006","West Bank and Gaza","Income share held by third 20%",16.1,"SEPTEMBER",32,1,"medium_poverty",33
"548","2006","West Bank and Gaza","Income share held by third 20%",16.1,"AUGUST",74,1,"medium_poverty",75
"549","2006","West Bank and Gaza","Income share held by third 20%",16.1,"JULY",180,2,"medium_poverty",182
"550","2006","West Bank and Gaza","Income share held by third 20%",16.1,"MARCH",15,5,"medium_poverty",20
"551","2006","West Bank and Gaza","Income share held by third 20%",16.1,"DECEMBER",14,0,"medium_poverty",14
"552","2006","West Bank and Gaza","Income share held by third 20%",16.1,"JANUARY",13,0,"medium_poverty",13
"553","2006","West Bank and Gaza","Poverty headcount ratio at $2.15 a day (2017 PPP) (% of population)",0.3,"APRIL",31,7,"high_poverty",38
"554","2006","West Bank and Gaza","Poverty headcount ratio at $2.15 a day (2017 PPP) (% of population)",0.3,"JUNE",43,3,"high_poverty",46
"555","2006","West Bank and Gaza","Poverty headcount ratio at $2.15 a day (2017 PPP) (% of population)",0.3,"MAY",37,0,"high_poverty",37
"556","2006","West Bank and Gaza","Poverty headcount ratio at $2.15 a day (2017 PPP) (% of population)",0.3,"FEBRUARY",31,1,"high_poverty",32
"557","2006","West Bank and Gaza","Poverty headcount ratio at $2.15 a day (2017 PPP) (% of population)",0.3,"NOVEMBER",134,0,"high_poverty",134
"558","2006","West Bank and Gaza","Poverty headcount ratio at $2.15 a day (2017 PPP) (% of population)",0.3,"OCTOBER",61,0,"high_poverty",61
"559","2006","West Bank and Gaza","Poverty headcount ratio at $2.15 a day (2017 PPP) (% of population)",0.3,"SEPTEMBER",32,1,"high_poverty",33
"560","2006","West Bank and Gaza","Poverty headcount ratio at $2.15 a day (2017 PPP) (% of population)",0.3,"AUGUST",74,1,"high_poverty",75
"561","2006","West Bank and Gaza","Poverty headcount ratio at $2.15 a day (2017 PPP) (% of population)",0.3,"JULY",180,2,"high_poverty",182
"562","2006","West Bank and Gaza","Poverty headcount ratio at $2.15 a day (2017 PPP) (% of population)",0.3,"MARCH",15,5,"high_poverty",20
"563","2006","West Bank and Gaza","Poverty headcount ratio at $2.15 a day (2017 PPP) (% of population)",0.3,"DECEMBER",14,0,"high_poverty",14
"564","2006","West Bank and Gaza","Poverty headcount ratio at $2.15 a day (2017 PPP) (% of population)",0.3,"JANUARY",13,0,"high_poverty",13
"565","2006","West Bank and Gaza","Poverty gap at $2.15 a day (2017 PPP) (%)",0,"APRIL",31,7,"high_poverty",38
"566","2006","West Bank and Gaza","Poverty gap at $2.15 a day (2017 PPP) (%)",0,"JUNE",43,3,"high_poverty",46
"567","2006","West Bank and Gaza","Poverty gap at $2.15 a day (2017 PPP) (%)",0,"MAY",37,0,"high_poverty",37
"568","2006","West Bank and Gaza","Poverty gap at $2.15 a day (2017 PPP) (%)",0,"FEBRUARY",31,1,"high_poverty",32
"569","2006","West Bank and Gaza","Poverty gap at $2.15 a day (2017 PPP) (%)",0,"NOVEMBER",134,0,"high_poverty",134
"570","2006","West Bank and Gaza","Poverty gap at $2.15 a day (2017 PPP) (%)",0,"OCTOBER",61,0,"high_poverty",61
"571","2006","West Bank and Gaza","Poverty gap at $2.15 a day (2017 PPP) (%)",0,"SEPTEMBER",32,1,"high_poverty",33
"572","2006","West Bank and Gaza","Poverty gap at $2.15 a day (2017 PPP) (%)",0,"AUGUST",74,1,"high_poverty",75
"573","2006","West Bank and Gaza","Poverty gap at $2.15 a day (2017 PPP) (%)",0,"JULY",180,2,"high_poverty",182
"574","2006","West Bank and Gaza","Poverty gap at $2.15 a day (2017 PPP) (%)",0,"MARCH",15,5,"high_poverty",20
"575","2006","West Bank and Gaza","Poverty gap at $2.15 a day (2017 PPP) (%)",0,"DECEMBER",14,0,"high_poverty",14
"576","2006","West Bank and Gaza","Poverty gap at $2.15 a day (2017 PPP) (%)",0,"JANUARY",13,0,"high_poverty",13
"577","2007","West Bank and Gaza","Proportion of people living below 50 percent of median income (%)",11.3,"SEPTEMBER",34,0,"medium_poverty",34
"578","2007","West Bank and Gaza","Proportion of people living below 50 percent of median income (%)",11.3,"JULY",27,1,"medium_poverty",28
"579","2007","West Bank and Gaza","Proportion of people living below 50 percent of median income (%)",11.3,"OCTOBER",36,2,"medium_poverty",38
"580","2007","West Bank and Gaza","Proportion of people living below 50 percent of median income (%)",11.3,"MAY",62,2,"medium_poverty",64
"581","2007","West Bank and Gaza","Proportion of people living below 50 percent of median income (%)",11.3,"AUGUST",47,0,"medium_poverty",47
"582","2007","West Bank and Gaza","Proportion of people living below 50 percent of median income (%)",11.3,"MARCH",9,0,"medium_poverty",9
"583","2007","West Bank and Gaza","Proportion of people living below 50 percent of median income (%)",11.3,"JUNE",40,0,"medium_poverty",40
"584","2007","West Bank and Gaza","Proportion of people living below 50 percent of median income (%)",11.3,"JANUARY",10,3,"medium_poverty",13
"585","2007","West Bank and Gaza","Proportion of people living below 50 percent of median income (%)",11.3,"APRIL",16,0,"medium_poverty",16
"586","2007","West Bank and Gaza","Proportion of people living below 50 percent of median income (%)",11.3,"DECEMBER",61,2,"medium_poverty",63
"587","2007","West Bank and Gaza","Proportion of people living below 50 percent of median income (%)",11.3,"FEBRUARY",12,1,"medium_poverty",13
"588","2007","West Bank and Gaza","Proportion of people living below 50 percent of median income (%)",11.3,"NOVEMBER",31,1,"medium_poverty",32
"589","2007","West Bank and Gaza","Income share held by lowest 20%",7.1,"SEPTEMBER",34,0,"high_poverty",34
"590","2007","West Bank and Gaza","Income share held by lowest 20%",7.1,"JULY",27,1,"high_poverty",28
"591","2007","West Bank and Gaza","Income share held by lowest 20%",7.1,"OCTOBER",36,2,"high_poverty",38
"592","2007","West Bank and Gaza","Income share held by lowest 20%",7.1,"MAY",62,2,"high_poverty",64
"593","2007","West Bank and Gaza","Income share held by lowest 20%",7.1,"AUGUST",47,0,"high_poverty",47
"594","2007","West Bank and Gaza","Income share held by lowest 20%",7.1,"MARCH",9,0,"high_poverty",9
"595","2007","West Bank and Gaza","Income share held by lowest 20%",7.1,"JUNE",40,0,"high_poverty",40
"596","2007","West Bank and Gaza","Income share held by lowest 20%",7.1,"JANUARY",10,3,"high_poverty",13
"597","2007","West Bank and Gaza","Income share held by lowest 20%",7.1,"APRIL",16,0,"high_poverty",16
"598","2007","West Bank and Gaza","Income share held by lowest 20%",7.1,"DECEMBER",61,2,"high_poverty",63
"599","2007","West Bank and Gaza","Income share held by lowest 20%",7.1,"FEBRUARY",12,1,"high_poverty",13
"600","2007","West Bank and Gaza","Income share held by lowest 20%",7.1,"NOVEMBER",31,1,"high_poverty",32
"601","2007","West Bank and Gaza","Income share held by lowest 10%",2.8,"SEPTEMBER",34,0,"high_poverty",34
"602","2007","West Bank and Gaza","Income share held by lowest 10%",2.8,"JULY",27,1,"high_poverty",28
"603","2007","West Bank and Gaza","Income share held by lowest 10%",2.8,"OCTOBER",36,2,"high_poverty",38
"604","2007","West Bank and Gaza","Income share held by lowest 10%",2.8,"MAY",62,2,"high_poverty",64
"605","2007","West Bank and Gaza","Income share held by lowest 10%",2.8,"AUGUST",47,0,"high_poverty",47
"606","2007","West Bank and Gaza","Income share held by lowest 10%",2.8,"MARCH",9,0,"high_poverty",9
"607","2007","West Bank and Gaza","Income share held by lowest 10%",2.8,"JUNE",40,0,"high_poverty",40
"608","2007","West Bank and Gaza","Income share held by lowest 10%",2.8,"JANUARY",10,3,"high_poverty",13
"609","2007","West Bank and Gaza","Income share held by lowest 10%",2.8,"APRIL",16,0,"high_poverty",16
"610","2007","West Bank and Gaza","Income share held by lowest 10%",2.8,"DECEMBER",61,2,"high_poverty",63
"611","2007","West Bank and Gaza","Income share held by lowest 10%",2.8,"FEBRUARY",12,1,"high_poverty",13
"612","2007","West Bank and Gaza","Income share held by lowest 10%",2.8,"NOVEMBER",31,1,"high_poverty",32
"613","2007","West Bank and Gaza","Income share held by fourth 20%",22.3,"SEPTEMBER",34,0,"medium_poverty",34
"614","2007","West Bank and Gaza","Income share held by fourth 20%",22.3,"JULY",27,1,"medium_poverty",28
"615","2007","West Bank and Gaza","Income share held by fourth 20%",22.3,"OCTOBER",36,2,"medium_poverty",38
"616","2007","West Bank and Gaza","Income share held by fourth 20%",22.3,"MAY",62,2,"medium_poverty",64
"617","2007","West Bank and Gaza","Income share held by fourth 20%",22.3,"AUGUST",47,0,"medium_poverty",47
"618","2007","West Bank and Gaza","Income share held by fourth 20%",22.3,"MARCH",9,0,"medium_poverty",9
"619","2007","West Bank and Gaza","Income share held by fourth 20%",22.3,"JUNE",40,0,"medium_poverty",40
"620","2007","West Bank and Gaza","Income share held by fourth 20%",22.3,"JANUARY",10,3,"medium_poverty",13
"621","2007","West Bank and Gaza","Income share held by fourth 20%",22.3,"APRIL",16,0,"medium_poverty",16
"622","2007","West Bank and Gaza","Income share held by fourth 20%",22.3,"DECEMBER",61,2,"medium_poverty",63
"623","2007","West Bank and Gaza","Income share held by fourth 20%",22.3,"FEBRUARY",12,1,"medium_poverty",13
"624","2007","West Bank and Gaza","Income share held by fourth 20%",22.3,"NOVEMBER",31,1,"medium_poverty",32
"625","2007","West Bank and Gaza","Income share held by highest 20%",43,"SEPTEMBER",34,0,"medium_poverty",34
"626","2007","West Bank and Gaza","Income share held by highest 20%",43,"JULY",27,1,"medium_poverty",28
"627","2007","West Bank and Gaza","Income share held by highest 20%",43,"OCTOBER",36,2,"medium_poverty",38
"628","2007","West Bank and Gaza","Income share held by highest 20%",43,"MAY",62,2,"medium_poverty",64
"629","2007","West Bank and Gaza","Income share held by highest 20%",43,"AUGUST",47,0,"medium_poverty",47
"630","2007","West Bank and Gaza","Income share held by highest 20%",43,"MARCH",9,0,"medium_poverty",9
"631","2007","West Bank and Gaza","Income share held by highest 20%",43,"JUNE",40,0,"medium_poverty",40
"632","2007","West Bank and Gaza","Income share held by highest 20%",43,"JANUARY",10,3,"medium_poverty",13
"633","2007","West Bank and Gaza","Income share held by highest 20%",43,"APRIL",16,0,"medium_poverty",16
"634","2007","West Bank and Gaza","Income share held by highest 20%",43,"DECEMBER",61,2,"medium_poverty",63
"635","2007","West Bank and Gaza","Income share held by highest 20%",43,"FEBRUARY",12,1,"medium_poverty",13
"636","2007","West Bank and Gaza","Income share held by highest 20%",43,"NOVEMBER",31,1,"medium_poverty",32
"637","2007","West Bank and Gaza","Poverty gap at $3.65 a day (2017 PPP) (%)",1.3,"SEPTEMBER",34,0,"high_poverty",34
"638","2007","West Bank and Gaza","Poverty gap at $3.65 a day (2017 PPP) (%)",1.3,"JULY",27,1,"high_poverty",28
"639","2007","West Bank and Gaza","Poverty gap at $3.65 a day (2017 PPP) (%)",1.3,"OCTOBER",36,2,"high_poverty",38
"640","2007","West Bank and Gaza","Poverty gap at $3.65 a day (2017 PPP) (%)",1.3,"MAY",62,2,"high_poverty",64
"641","2007","West Bank and Gaza","Poverty gap at $3.65 a day (2017 PPP) (%)",1.3,"AUGUST",47,0,"high_poverty",47
"642","2007","West Bank and Gaza","Poverty gap at $3.65 a day (2017 PPP) (%)",1.3,"MARCH",9,0,"high_poverty",9
"643","2007","West Bank and Gaza","Poverty gap at $3.65 a day (2017 PPP) (%)",1.3,"JUNE",40,0,"high_poverty",40
"644","2007","West Bank and Gaza","Poverty gap at $3.65 a day (2017 PPP) (%)",1.3,"JANUARY",10,3,"high_poverty",13
"645","2007","West Bank and Gaza","Poverty gap at $3.65 a day (2017 PPP) (%)",1.3,"APRIL",16,0,"high_poverty",16
"646","2007","West Bank and Gaza","Poverty gap at $3.65 a day (2017 PPP) (%)",1.3,"DECEMBER",61,2,"high_poverty",63
"647","2007","West Bank and Gaza","Poverty gap at $3.65 a day (2017 PPP) (%)",1.3,"FEBRUARY",12,1,"high_poverty",13
"648","2007","West Bank and Gaza","Poverty gap at $3.65 a day (2017 PPP) (%)",1.3,"NOVEMBER",31,1,"high_poverty",32
"649","2007","West Bank and Gaza","Income share held by second 20%",11.6,"SEPTEMBER",34,0,"medium_poverty",34
"650","2007","West Bank and Gaza","Income share held by second 20%",11.6,"JULY",27,1,"medium_poverty",28
"651","2007","West Bank and Gaza","Income share held by second 20%",11.6,"OCTOBER",36,2,"medium_poverty",38
"652","2007","West Bank and Gaza","Income share held by second 20%",11.6,"MAY",62,2,"medium_poverty",64
"653","2007","West Bank and Gaza","Income share held by second 20%",11.6,"AUGUST",47,0,"medium_poverty",47
"654","2007","West Bank and Gaza","Income share held by second 20%",11.6,"MARCH",9,0,"medium_poverty",9
"655","2007","West Bank and Gaza","Income share held by second 20%",11.6,"JUNE",40,0,"medium_poverty",40
"656","2007","West Bank and Gaza","Income share held by second 20%",11.6,"JANUARY",10,3,"medium_poverty",13
"657","2007","West Bank and Gaza","Income share held by second 20%",11.6,"APRIL",16,0,"medium_poverty",16
"658","2007","West Bank and Gaza","Income share held by second 20%",11.6,"DECEMBER",61,2,"medium_poverty",63
"659","2007","West Bank and Gaza","Income share held by second 20%",11.6,"FEBRUARY",12,1,"medium_poverty",13
"660","2007","West Bank and Gaza","Income share held by second 20%",11.6,"NOVEMBER",31,1,"medium_poverty",32
"661","2007","West Bank and Gaza","Income share held by highest 10%",27.6,"SEPTEMBER",34,0,"medium_poverty",34
"662","2007","West Bank and Gaza","Income share held by highest 10%",27.6,"JULY",27,1,"medium_poverty",28
"663","2007","West Bank and Gaza","Income share held by highest 10%",27.6,"OCTOBER",36,2,"medium_poverty",38
"664","2007","West Bank and Gaza","Income share held by highest 10%",27.6,"MAY",62,2,"medium_poverty",64
"665","2007","West Bank and Gaza","Income share held by highest 10%",27.6,"AUGUST",47,0,"medium_poverty",47
"666","2007","West Bank and Gaza","Income share held by highest 10%",27.6,"MARCH",9,0,"medium_poverty",9
"667","2007","West Bank and Gaza","Income share held by highest 10%",27.6,"JUNE",40,0,"medium_poverty",40
"668","2007","West Bank and Gaza","Income share held by highest 10%",27.6,"JANUARY",10,3,"medium_poverty",13
"669","2007","West Bank and Gaza","Income share held by highest 10%",27.6,"APRIL",16,0,"medium_poverty",16
"670","2007","West Bank and Gaza","Income share held by highest 10%",27.6,"DECEMBER",61,2,"medium_poverty",63
"671","2007","West Bank and Gaza","Income share held by highest 10%",27.6,"FEBRUARY",12,1,"medium_poverty",13
"672","2007","West Bank and Gaza","Income share held by highest 10%",27.6,"NOVEMBER",31,1,"medium_poverty",32
"673","2007","West Bank and Gaza","Gini index",35.6,"SEPTEMBER",34,0,"medium_poverty",34
"674","2007","West Bank and Gaza","Gini index",35.6,"JULY",27,1,"medium_poverty",28
"675","2007","West Bank and Gaza","Gini index",35.6,"OCTOBER",36,2,"medium_poverty",38
"676","2007","West Bank and Gaza","Gini index",35.6,"MAY",62,2,"medium_poverty",64
"677","2007","West Bank and Gaza","Gini index",35.6,"AUGUST",47,0,"medium_poverty",47
"678","2007","West Bank and Gaza","Gini index",35.6,"MARCH",9,0,"medium_poverty",9
"679","2007","West Bank and Gaza","Gini index",35.6,"JUNE",40,0,"medium_poverty",40
"680","2007","West Bank and Gaza","Gini index",35.6,"JANUARY",10,3,"medium_poverty",13
"681","2007","West Bank and Gaza","Gini index",35.6,"APRIL",16,0,"medium_poverty",16
"682","2007","West Bank and Gaza","Gini index",35.6,"DECEMBER",61,2,"medium_poverty",63
"683","2007","West Bank and Gaza","Gini index",35.6,"FEBRUARY",12,1,"medium_poverty",13
"684","2007","West Bank and Gaza","Gini index",35.6,"NOVEMBER",31,1,"medium_poverty",32
"685","2007","West Bank and Gaza","Income share held by third 20%",16.1,"SEPTEMBER",34,0,"medium_poverty",34
"686","2007","West Bank and Gaza","Income share held by third 20%",16.1,"JULY",27,1,"medium_poverty",28
"687","2007","West Bank and Gaza","Income share held by third 20%",16.1,"OCTOBER",36,2,"medium_poverty",38
"688","2007","West Bank and Gaza","Income share held by third 20%",16.1,"MAY",62,2,"medium_poverty",64
"689","2007","West Bank and Gaza","Income share held by third 20%",16.1,"AUGUST",47,0,"medium_poverty",47
"690","2007","West Bank and Gaza","Income share held by third 20%",16.1,"MARCH",9,0,"medium_poverty",9
"691","2007","West Bank and Gaza","Income share held by third 20%",16.1,"JUNE",40,0,"medium_poverty",40
"692","2007","West Bank and Gaza","Income share held by third 20%",16.1,"JANUARY",10,3,"medium_poverty",13
"693","2007","West Bank and Gaza","Income share held by third 20%",16.1,"APRIL",16,0,"medium_poverty",16
"694","2007","West Bank and Gaza","Income share held by third 20%",16.1,"DECEMBER",61,2,"medium_poverty",63
"695","2007","West Bank and Gaza","Income share held by third 20%",16.1,"FEBRUARY",12,1,"medium_poverty",13
"696","2007","West Bank and Gaza","Income share held by third 20%",16.1,"NOVEMBER",31,1,"medium_poverty",32
"697","2007","West Bank and Gaza","Poverty headcount ratio at $2.15 a day (2017 PPP) (% of population)",1.4,"SEPTEMBER",34,0,"high_poverty",34
"698","2007","West Bank and Gaza","Poverty headcount ratio at $2.15 a day (2017 PPP) (% of population)",1.4,"JULY",27,1,"high_poverty",28
"699","2007","West Bank and Gaza","Poverty headcount ratio at $2.15 a day (2017 PPP) (% of population)",1.4,"OCTOBER",36,2,"high_poverty",38
"700","2007","West Bank and Gaza","Poverty headcount ratio at $2.15 a day (2017 PPP) (% of population)",1.4,"MAY",62,2,"high_poverty",64
"701","2007","West Bank and Gaza","Poverty headcount ratio at $2.15 a day (2017 PPP) (% of population)",1.4,"AUGUST",47,0,"high_poverty",47
"702","2007","West Bank and Gaza","Poverty headcount ratio at $2.15 a day (2017 PPP) (% of population)",1.4,"MARCH",9,0,"high_poverty",9
"703","2007","West Bank and Gaza","Poverty headcount ratio at $2.15 a day (2017 PPP) (% of population)",1.4,"JUNE",40,0,"high_poverty",40
"704","2007","West Bank and Gaza","Poverty headcount ratio at $2.15 a day (2017 PPP) (% of population)",1.4,"JANUARY",10,3,"high_poverty",13
"705","2007","West Bank and Gaza","Poverty headcount ratio at $2.15 a day (2017 PPP) (% of population)",1.4,"APRIL",16,0,"high_poverty",16
"706","2007","West Bank and Gaza","Poverty headcount ratio at $2.15 a day (2017 PPP) (% of population)",1.4,"DECEMBER",61,2,"high_poverty",63
"707","2007","West Bank and Gaza","Poverty headcount ratio at $2.15 a day (2017 PPP) (% of population)",1.4,"FEBRUARY",12,1,"high_poverty",13
"708","2007","West Bank and Gaza","Poverty headcount ratio at $2.15 a day (2017 PPP) (% of population)",1.4,"NOVEMBER",31,1,"high_poverty",32
"709","2007","West Bank and Gaza","Poverty gap at $6.85 a day (2017 PPP) (%)",7.7,"SEPTEMBER",34,0,"high_poverty",34
"710","2007","West Bank and Gaza","Poverty gap at $6.85 a day (2017 PPP) (%)",7.7,"JULY",27,1,"high_poverty",28
"711","2007","West Bank and Gaza","Poverty gap at $6.85 a day (2017 PPP) (%)",7.7,"OCTOBER",36,2,"high_poverty",38
"712","2007","West Bank and Gaza","Poverty gap at $6.85 a day (2017 PPP) (%)",7.7,"MAY",62,2,"high_poverty",64
"713","2007","West Bank and Gaza","Poverty gap at $6.85 a day (2017 PPP) (%)",7.7,"AUGUST",47,0,"high_poverty",47
"714","2007","West Bank and Gaza","Poverty gap at $6.85 a day (2017 PPP) (%)",7.7,"MARCH",9,0,"high_poverty",9
"715","2007","West Bank and Gaza","Poverty gap at $6.85 a day (2017 PPP) (%)",7.7,"JUNE",40,0,"high_poverty",40
"716","2007","West Bank and Gaza","Poverty gap at $6.85 a day (2017 PPP) (%)",7.7,"JANUARY",10,3,"high_poverty",13
"717","2007","West Bank and Gaza","Poverty gap at $6.85 a day (2017 PPP) (%)",7.7,"APRIL",16,0,"high_poverty",16
"718","2007","West Bank and Gaza","Poverty gap at $6.85 a day (2017 PPP) (%)",7.7,"DECEMBER",61,2,"high_poverty",63
"719","2007","West Bank and Gaza","Poverty gap at $6.85 a day (2017 PPP) (%)",7.7,"FEBRUARY",12,1,"high_poverty",13
"720","2007","West Bank and Gaza","Poverty gap at $6.85 a day (2017 PPP) (%)",7.7,"NOVEMBER",31,1,"high_poverty",32
"721","2007","West Bank and Gaza","Poverty headcount ratio at $6.85 a day (2017 PPP) (% of population)",27.7,"SEPTEMBER",34,0,"high_poverty",34
"722","2007","West Bank and Gaza","Poverty headcount ratio at $6.85 a day (2017 PPP) (% of population)",27.7,"JULY",27,1,"high_poverty",28
"723","2007","West Bank and Gaza","Poverty headcount ratio at $6.85 a day (2017 PPP) (% of population)",27.7,"OCTOBER",36,2,"high_poverty",38
"724","2007","West Bank and Gaza","Poverty headcount ratio at $6.85 a day (2017 PPP) (% of population)",27.7,"MAY",62,2,"high_poverty",64
"725","2007","West Bank and Gaza","Poverty headcount ratio at $6.85 a day (2017 PPP) (% of population)",27.7,"AUGUST",47,0,"high_poverty",47
"726","2007","West Bank and Gaza","Poverty headcount ratio at $6.85 a day (2017 PPP) (% of population)",27.7,"MARCH",9,0,"high_poverty",9
"727","2007","West Bank and Gaza","Poverty headcount ratio at $6.85 a day (2017 PPP) (% of population)",27.7,"JUNE",40,0,"high_poverty",40
"728","2007","West Bank and Gaza","Poverty headcount ratio at $6.85 a day (2017 PPP) (% of population)",27.7,"JANUARY",10,3,"high_poverty",13
"729","2007","West Bank and Gaza","Poverty headcount ratio at $6.85 a day (2017 PPP) (% of population)",27.7,"APRIL",16,0,"high_poverty",16
"730","2007","West Bank and Gaza","Poverty headcount ratio at $6.85 a day (2017 PPP) (% of population)",27.7,"DECEMBER",61,2,"high_poverty",63
"731","2007","West Bank and Gaza","Poverty headcount ratio at $6.85 a day (2017 PPP) (% of population)",27.7,"FEBRUARY",12,1,"high_poverty",13
"732","2007","West Bank and Gaza","Poverty headcount ratio at $6.85 a day (2017 PPP) (% of population)",27.7,"NOVEMBER",31,1,"high_poverty",32
"733","2007","West Bank and Gaza","Poverty gap at $2.15 a day (2017 PPP) (%)",0.2,"SEPTEMBER",34,0,"high_poverty",34
"734","2007","West Bank and Gaza","Poverty gap at $2.15 a day (2017 PPP) (%)",0.2,"JULY",27,1,"high_poverty",28
"735","2007","West Bank and Gaza","Poverty gap at $2.15 a day (2017 PPP) (%)",0.2,"OCTOBER",36,2,"high_poverty",38
"736","2007","West Bank and Gaza","Poverty gap at $2.15 a day (2017 PPP) (%)",0.2,"MAY",62,2,"high_poverty",64
"737","2007","West Bank and Gaza","Poverty gap at $2.15 a day (2017 PPP) (%)",0.2,"AUGUST",47,0,"high_poverty",47
"738","2007","West Bank and Gaza","Poverty gap at $2.15 a day (2017 PPP) (%)",0.2,"MARCH",9,0,"high_poverty",9
"739","2007","West Bank and Gaza","Poverty gap at $2.15 a day (2017 PPP) (%)",0.2,"JUNE",40,0,"high_poverty",40
"740","2007","West Bank and Gaza","Poverty gap at $2.15 a day (2017 PPP) (%)",0.2,"JANUARY",10,3,"high_poverty",13
"741","2007","West Bank and Gaza","Poverty gap at $2.15 a day (2017 PPP) (%)",0.2,"APRIL",16,0,"high_poverty",16
"742","2007","West Bank and Gaza","Poverty gap at $2.15 a day (2017 PPP) (%)",0.2,"DECEMBER",61,2,"high_poverty",63
"743","2007","West Bank and Gaza","Poverty gap at $2.15 a day (2017 PPP) (%)",0.2,"FEBRUARY",12,1,"high_poverty",13
"744","2007","West Bank and Gaza","Poverty gap at $2.15 a day (2017 PPP) (%)",0.2,"NOVEMBER",31,1,"high_poverty",32
"745","2007","West Bank and Gaza","Poverty headcount ratio at $3.65 a day (2017 PPP) (% of population)",5.1,"SEPTEMBER",34,0,"high_poverty",34
"746","2007","West Bank and Gaza","Poverty headcount ratio at $3.65 a day (2017 PPP) (% of population)",5.1,"JULY",27,1,"high_poverty",28
"747","2007","West Bank and Gaza","Poverty headcount ratio at $3.65 a day (2017 PPP) (% of population)",5.1,"OCTOBER",36,2,"high_poverty",38
"748","2007","West Bank and Gaza","Poverty headcount ratio at $3.65 a day (2017 PPP) (% of population)",5.1,"MAY",62,2,"high_poverty",64
"749","2007","West Bank and Gaza","Poverty headcount ratio at $3.65 a day (2017 PPP) (% of population)",5.1,"AUGUST",47,0,"high_poverty",47
"750","2007","West Bank and Gaza","Poverty headcount ratio at $3.65 a day (2017 PPP) (% of population)",5.1,"MARCH",9,0,"high_poverty",9
"751","2007","West Bank and Gaza","Poverty headcount ratio at $3.65 a day (2017 PPP) (% of population)",5.1,"JUNE",40,0,"high_poverty",40
"752","2007","West Bank and Gaza","Poverty headcount ratio at $3.65 a day (2017 PPP) (% of population)",5.1,"JANUARY",10,3,"high_poverty",13
"753","2007","West Bank and Gaza","Poverty headcount ratio at $3.65 a day (2017 PPP) (% of population)",5.1,"APRIL",16,0,"high_poverty",16
"754","2007","West Bank and Gaza","Poverty headcount ratio at $3.65 a day (2017 PPP) (% of population)",5.1,"DECEMBER",61,2,"high_poverty",63
"755","2007","West Bank and Gaza","Poverty headcount ratio at $3.65 a day (2017 PPP) (% of population)",5.1,"FEBRUARY",12,1,"high_poverty",13
"756","2007","West Bank and Gaza","Poverty headcount ratio at $3.65 a day (2017 PPP) (% of population)",5.1,"NOVEMBER",31,1,"high_poverty",32
"757","2008","West Bank and Gaza","Population living in slums (% of urban population)",27.16442,"FEBRUARY",79,2,"medium_poverty",81
"758","2008","West Bank and Gaza","Population living in slums (% of urban population)",27.16442,"JANUARY",89,1,"medium_poverty",90
"759","2008","West Bank and Gaza","Population living in slums (% of urban population)",27.16442,"SEPTEMBER",3,0,"medium_poverty",3
"760","2008","West Bank and Gaza","Population living in slums (% of urban population)",27.16442,"AUGUST",0,4,"medium_poverty",4
"761","2008","West Bank and Gaza","Population living in slums (% of urban population)",27.16442,"JULY",8,4,"medium_poverty",12
"762","2008","West Bank and Gaza","Population living in slums (% of urban population)",27.16442,"JUNE",30,1,"medium_poverty",31
"763","2008","West Bank and Gaza","Population living in slums (% of urban population)",27.16442,"MAY",40,2,"medium_poverty",42
"764","2008","West Bank and Gaza","Population living in slums (% of urban population)",27.16442,"APRIL",72,8,"medium_poverty",80
"765","2008","West Bank and Gaza","Population living in slums (% of urban population)",27.16442,"MARCH",114,12,"medium_poverty",126
"766","2008","West Bank and Gaza","Population living in slums (% of urban population)",27.16442,"DECEMBER",432,4,"medium_poverty",436
"767","2008","West Bank and Gaza","Population living in slums (% of urban population)",27.16442,"NOVEMBER",15,0,"medium_poverty",15
"768","2008","West Bank and Gaza","Population living in slums (% of urban population)",27.16442,"OCTOBER",4,1,"medium_poverty",5
"769","2009","West Bank and Gaza","Income share held by fourth 20%",21.9,"JUNE",4,0,"medium_poverty",4
"770","2009","West Bank and Gaza","Income share held by fourth 20%",21.9,"JULY",2,0,"medium_poverty",2
"771","2009","West Bank and Gaza","Income share held by fourth 20%",21.9,"FEBRUARY",9,0,"medium_poverty",9
"772","2009","West Bank and Gaza","Income share held by fourth 20%",21.9,"MAY",6,1,"medium_poverty",7
"773","2009","West Bank and Gaza","Income share held by fourth 20%",21.9,"APRIL",6,1,"medium_poverty",7
"774","2009","West Bank and Gaza","Income share held by fourth 20%",21.9,"MARCH",9,0,"medium_poverty",9
"775","2009","West Bank and Gaza","Income share held by fourth 20%",21.9,"OCTOBER",0,0,"medium_poverty",0
"776","2009","West Bank and Gaza","Income share held by fourth 20%",21.9,"JANUARY",978,6,"medium_poverty",984
"777","2009","West Bank and Gaza","Income share held by fourth 20%",21.9,"DECEMBER",6,1,"medium_poverty",7
"778","2009","West Bank and Gaza","Income share held by fourth 20%",21.9,"NOVEMBER",1,0,"medium_poverty",1
"779","2009","West Bank and Gaza","Income share held by fourth 20%",21.9,"AUGUST",6,0,"medium_poverty",6
"780","2009","West Bank and Gaza","Income share held by fourth 20%",21.9,"SEPTEMBER",9,0,"medium_poverty",9
"781","2009","West Bank and Gaza","Income share held by second 20%",11.9,"JUNE",4,0,"medium_poverty",4
"782","2009","West Bank and Gaza","Income share held by second 20%",11.9,"JULY",2,0,"medium_poverty",2
"783","2009","West Bank and Gaza","Income share held by second 20%",11.9,"FEBRUARY",9,0,"medium_poverty",9
"784","2009","West Bank and Gaza","Income share held by second 20%",11.9,"MAY",6,1,"medium_poverty",7
"785","2009","West Bank and Gaza","Income share held by second 20%",11.9,"APRIL",6,1,"medium_poverty",7
"786","2009","West Bank and Gaza","Income share held by second 20%",11.9,"MARCH",9,0,"medium_poverty",9
"787","2009","West Bank and Gaza","Income share held by second 20%",11.9,"OCTOBER",0,0,"medium_poverty",0
"788","2009","West Bank and Gaza","Income share held by second 20%",11.9,"JANUARY",978,6,"medium_poverty",984
"789","2009","West Bank and Gaza","Income share held by second 20%",11.9,"DECEMBER",6,1,"medium_poverty",7
"790","2009","West Bank and Gaza","Income share held by second 20%",11.9,"NOVEMBER",1,0,"medium_poverty",1
"791","2009","West Bank and Gaza","Income share held by second 20%",11.9,"AUGUST",6,0,"medium_poverty",6
"792","2009","West Bank and Gaza","Income share held by second 20%",11.9,"SEPTEMBER",9,0,"medium_poverty",9
"793","2009","West Bank and Gaza","Poverty gap at $3.65 a day (2017 PPP) (%)",0.3,"JUNE",4,0,"high_poverty",4
"794","2009","West Bank and Gaza","Poverty gap at $3.65 a day (2017 PPP) (%)",0.3,"JULY",2,0,"high_poverty",2
"795","2009","West Bank and Gaza","Poverty gap at $3.65 a day (2017 PPP) (%)",0.3,"FEBRUARY",9,0,"high_poverty",9
"796","2009","West Bank and Gaza","Poverty gap at $3.65 a day (2017 PPP) (%)",0.3,"MAY",6,1,"high_poverty",7
"797","2009","West Bank and Gaza","Poverty gap at $3.65 a day (2017 PPP) (%)",0.3,"APRIL",6,1,"high_poverty",7
"798","2009","West Bank and Gaza","Poverty gap at $3.65 a day (2017 PPP) (%)",0.3,"MARCH",9,0,"high_poverty",9
"799","2009","West Bank and Gaza","Poverty gap at $3.65 a day (2017 PPP) (%)",0.3,"OCTOBER",0,0,"high_poverty",0
"800","2009","West Bank and Gaza","Poverty gap at $3.65 a day (2017 PPP) (%)",0.3,"JANUARY",978,6,"high_poverty",984
"801","2009","West Bank and Gaza","Poverty gap at $3.65 a day (2017 PPP) (%)",0.3,"DECEMBER",6,1,"high_poverty",7
"802","2009","West Bank and Gaza","Poverty gap at $3.65 a day (2017 PPP) (%)",0.3,"NOVEMBER",1,0,"high_poverty",1
"803","2009","West Bank and Gaza","Poverty gap at $3.65 a day (2017 PPP) (%)",0.3,"AUGUST",6,0,"high_poverty",6
"804","2009","West Bank and Gaza","Poverty gap at $3.65 a day (2017 PPP) (%)",0.3,"SEPTEMBER",9,0,"high_poverty",9
"805","2009","West Bank and Gaza","Gini index",34.5,"JUNE",4,0,"medium_poverty",4
"806","2009","West Bank and Gaza","Gini index",34.5,"JULY",2,0,"medium_poverty",2
"807","2009","West Bank and Gaza","Gini index",34.5,"FEBRUARY",9,0,"medium_poverty",9
"808","2009","West Bank and Gaza","Gini index",34.5,"MAY",6,1,"medium_poverty",7
"809","2009","West Bank and Gaza","Gini index",34.5,"APRIL",6,1,"medium_poverty",7
"810","2009","West Bank and Gaza","Gini index",34.5,"MARCH",9,0,"medium_poverty",9
"811","2009","West Bank and Gaza","Gini index",34.5,"OCTOBER",0,0,"medium_poverty",0
"812","2009","West Bank and Gaza","Gini index",34.5,"JANUARY",978,6,"medium_poverty",984
"813","2009","West Bank and Gaza","Gini index",34.5,"DECEMBER",6,1,"medium_poverty",7
"814","2009","West Bank and Gaza","Gini index",34.5,"NOVEMBER",1,0,"medium_poverty",1
"815","2009","West Bank and Gaza","Gini index",34.5,"AUGUST",6,0,"medium_poverty",6
"816","2009","West Bank and Gaza","Gini index",34.5,"SEPTEMBER",9,0,"medium_poverty",9
"817","2009","West Bank and Gaza","Poverty headcount ratio at $3.65 a day (2017 PPP) (% of population)",1.7,"JUNE",4,0,"high_poverty",4
"818","2009","West Bank and Gaza","Poverty headcount ratio at $3.65 a day (2017 PPP) (% of population)",1.7,"JULY",2,0,"high_poverty",2
"819","2009","West Bank and Gaza","Poverty headcount ratio at $3.65 a day (2017 PPP) (% of population)",1.7,"FEBRUARY",9,0,"high_poverty",9
"820","2009","West Bank and Gaza","Poverty headcount ratio at $3.65 a day (2017 PPP) (% of population)",1.7,"MAY",6,1,"high_poverty",7
"821","2009","West Bank and Gaza","Poverty headcount ratio at $3.65 a day (2017 PPP) (% of population)",1.7,"APRIL",6,1,"high_poverty",7
"822","2009","West Bank and Gaza","Poverty headcount ratio at $3.65 a day (2017 PPP) (% of population)",1.7,"MARCH",9,0,"high_poverty",9
"823","2009","West Bank and Gaza","Poverty headcount ratio at $3.65 a day (2017 PPP) (% of population)",1.7,"OCTOBER",0,0,"high_poverty",0
"824","2009","West Bank and Gaza","Poverty headcount ratio at $3.65 a day (2017 PPP) (% of population)",1.7,"JANUARY",978,6,"high_poverty",984
"825","2009","West Bank and Gaza","Poverty headcount ratio at $3.65 a day (2017 PPP) (% of population)",1.7,"DECEMBER",6,1,"high_poverty",7
"826","2009","West Bank and Gaza","Poverty headcount ratio at $3.65 a day (2017 PPP) (% of population)",1.7,"NOVEMBER",1,0,"high_poverty",1
"827","2009","West Bank and Gaza","Poverty headcount ratio at $3.65 a day (2017 PPP) (% of population)",1.7,"AUGUST",6,0,"high_poverty",6
"828","2009","West Bank and Gaza","Poverty headcount ratio at $3.65 a day (2017 PPP) (% of population)",1.7,"SEPTEMBER",9,0,"high_poverty",9
"829","2009","West Bank and Gaza","Income share held by lowest 20%",7.7,"JUNE",4,0,"high_poverty",4
"830","2009","West Bank and Gaza","Income share held by lowest 20%",7.7,"JULY",2,0,"high_poverty",2
"831","2009","West Bank and Gaza","Income share held by lowest 20%",7.7,"FEBRUARY",9,0,"high_poverty",9
"832","2009","West Bank and Gaza","Income share held by lowest 20%",7.7,"MAY",6,1,"high_poverty",7
"833","2009","West Bank and Gaza","Income share held by lowest 20%",7.7,"APRIL",6,1,"high_poverty",7
"834","2009","West Bank and Gaza","Income share held by lowest 20%",7.7,"MARCH",9,0,"high_poverty",9
"835","2009","West Bank and Gaza","Income share held by lowest 20%",7.7,"OCTOBER",0,0,"high_poverty",0
"836","2009","West Bank and Gaza","Income share held by lowest 20%",7.7,"JANUARY",978,6,"high_poverty",984
"837","2009","West Bank and Gaza","Income share held by lowest 20%",7.7,"DECEMBER",6,1,"high_poverty",7
"838","2009","West Bank and Gaza","Income share held by lowest 20%",7.7,"NOVEMBER",1,0,"high_poverty",1
"839","2009","West Bank and Gaza","Income share held by lowest 20%",7.7,"AUGUST",6,0,"high_poverty",6
"840","2009","West Bank and Gaza","Income share held by lowest 20%",7.7,"SEPTEMBER",9,0,"high_poverty",9
"841","2009","West Bank and Gaza","Poverty headcount ratio at $2.15 a day (2017 PPP) (% of population)",0.3,"JUNE",4,0,"high_poverty",4
"842","2009","West Bank and Gaza","Poverty headcount ratio at $2.15 a day (2017 PPP) (% of population)",0.3,"JULY",2,0,"high_poverty",2
"843","2009","West Bank and Gaza","Poverty headcount ratio at $2.15 a day (2017 PPP) (% of population)",0.3,"FEBRUARY",9,0,"high_poverty",9
"844","2009","West Bank and Gaza","Poverty headcount ratio at $2.15 a day (2017 PPP) (% of population)",0.3,"MAY",6,1,"high_poverty",7
"845","2009","West Bank and Gaza","Poverty headcount ratio at $2.15 a day (2017 PPP) (% of population)",0.3,"APRIL",6,1,"high_poverty",7
"846","2009","West Bank and Gaza","Poverty headcount ratio at $2.15 a day (2017 PPP) (% of population)",0.3,"MARCH",9,0,"high_poverty",9
"847","2009","West Bank and Gaza","Poverty headcount ratio at $2.15 a day (2017 PPP) (% of population)",0.3,"OCTOBER",0,0,"high_poverty",0
"848","2009","West Bank and Gaza","Poverty headcount ratio at $2.15 a day (2017 PPP) (% of population)",0.3,"JANUARY",978,6,"high_poverty",984
"849","2009","West Bank and Gaza","Poverty headcount ratio at $2.15 a day (2017 PPP) (% of population)",0.3,"DECEMBER",6,1,"high_poverty",7
"850","2009","West Bank and Gaza","Poverty headcount ratio at $2.15 a day (2017 PPP) (% of population)",0.3,"NOVEMBER",1,0,"high_poverty",1
"851","2009","West Bank and Gaza","Poverty headcount ratio at $2.15 a day (2017 PPP) (% of population)",0.3,"AUGUST",6,0,"high_poverty",6
"852","2009","West Bank and Gaza","Poverty headcount ratio at $2.15 a day (2017 PPP) (% of population)",0.3,"SEPTEMBER",9,0,"high_poverty",9
"853","2009","West Bank and Gaza","Income share held by highest 10%",27.4,"JUNE",4,0,"medium_poverty",4
"854","2009","West Bank and Gaza","Income share held by highest 10%",27.4,"JULY",2,0,"medium_poverty",2
"855","2009","West Bank and Gaza","Income share held by highest 10%",27.4,"FEBRUARY",9,0,"medium_poverty",9
"856","2009","West Bank and Gaza","Income share held by highest 10%",27.4,"MAY",6,1,"medium_poverty",7
"857","2009","West Bank and Gaza","Income share held by highest 10%",27.4,"APRIL",6,1,"medium_poverty",7
"858","2009","West Bank and Gaza","Income share held by highest 10%",27.4,"MARCH",9,0,"medium_poverty",9
"859","2009","West Bank and Gaza","Income share held by highest 10%",27.4,"OCTOBER",0,0,"medium_poverty",0
"860","2009","West Bank and Gaza","Income share held by highest 10%",27.4,"JANUARY",978,6,"medium_poverty",984
"861","2009","West Bank and Gaza","Income share held by highest 10%",27.4,"DECEMBER",6,1,"medium_poverty",7
"862","2009","West Bank and Gaza","Income share held by highest 10%",27.4,"NOVEMBER",1,0,"medium_poverty",1
"863","2009","West Bank and Gaza","Income share held by highest 10%",27.4,"AUGUST",6,0,"medium_poverty",6
"864","2009","West Bank and Gaza","Income share held by highest 10%",27.4,"SEPTEMBER",9,0,"medium_poverty",9
"865","2009","West Bank and Gaza","Poverty gap at $6.85 a day (2017 PPP) (%)",4.1,"JUNE",4,0,"high_poverty",4
"866","2009","West Bank and Gaza","Poverty gap at $6.85 a day (2017 PPP) (%)",4.1,"JULY",2,0,"high_poverty",2
"867","2009","West Bank and Gaza","Poverty gap at $6.85 a day (2017 PPP) (%)",4.1,"FEBRUARY",9,0,"high_poverty",9
"868","2009","West Bank and Gaza","Poverty gap at $6.85 a day (2017 PPP) (%)",4.1,"MAY",6,1,"high_poverty",7
"869","2009","West Bank and Gaza","Poverty gap at $6.85 a day (2017 PPP) (%)",4.1,"APRIL",6,1,"high_poverty",7
"870","2009","West Bank and Gaza","Poverty gap at $6.85 a day (2017 PPP) (%)",4.1,"MARCH",9,0,"high_poverty",9
"871","2009","West Bank and Gaza","Poverty gap at $6.85 a day (2017 PPP) (%)",4.1,"OCTOBER",0,0,"high_poverty",0
"872","2009","West Bank and Gaza","Poverty gap at $6.85 a day (2017 PPP) (%)",4.1,"JANUARY",978,6,"high_poverty",984
"873","2009","West Bank and Gaza","Poverty gap at $6.85 a day (2017 PPP) (%)",4.1,"DECEMBER",6,1,"high_poverty",7
"874","2009","West Bank and Gaza","Poverty gap at $6.85 a day (2017 PPP) (%)",4.1,"NOVEMBER",1,0,"high_poverty",1
"875","2009","West Bank and Gaza","Poverty gap at $6.85 a day (2017 PPP) (%)",4.1,"AUGUST",6,0,"high_poverty",6
"876","2009","West Bank and Gaza","Poverty gap at $6.85 a day (2017 PPP) (%)",4.1,"SEPTEMBER",9,0,"high_poverty",9
"877","2009","West Bank and Gaza","Poverty gap at $2.15 a day (2017 PPP) (%)",0,"JUNE",4,0,"high_poverty",4
"878","2009","West Bank and Gaza","Poverty gap at $2.15 a day (2017 PPP) (%)",0,"JULY",2,0,"high_poverty",2
"879","2009","West Bank and Gaza","Poverty gap at $2.15 a day (2017 PPP) (%)",0,"FEBRUARY",9,0,"high_poverty",9
"880","2009","West Bank and Gaza","Poverty gap at $2.15 a day (2017 PPP) (%)",0,"MAY",6,1,"high_poverty",7
"881","2009","West Bank and Gaza","Poverty gap at $2.15 a day (2017 PPP) (%)",0,"APRIL",6,1,"high_poverty",7
"882","2009","West Bank and Gaza","Poverty gap at $2.15 a day (2017 PPP) (%)",0,"MARCH",9,0,"high_poverty",9
"883","2009","West Bank and Gaza","Poverty gap at $2.15 a day (2017 PPP) (%)",0,"OCTOBER",0,0,"high_poverty",0
"884","2009","West Bank and Gaza","Poverty gap at $2.15 a day (2017 PPP) (%)",0,"JANUARY",978,6,"high_poverty",984
"885","2009","West Bank and Gaza","Poverty gap at $2.15 a day (2017 PPP) (%)",0,"DECEMBER",6,1,"high_poverty",7
"886","2009","West Bank and Gaza","Poverty gap at $2.15 a day (2017 PPP) (%)",0,"NOVEMBER",1,0,"high_poverty",1
"887","2009","West Bank and Gaza","Poverty gap at $2.15 a day (2017 PPP) (%)",0,"AUGUST",6,0,"high_poverty",6
"888","2009","West Bank and Gaza","Poverty gap at $2.15 a day (2017 PPP) (%)",0,"SEPTEMBER",9,0,"high_poverty",9
"889","2009","West Bank and Gaza","Income share held by highest 20%",42.6,"JUNE",4,0,"medium_poverty",4
"890","2009","West Bank and Gaza","Income share held by highest 20%",42.6,"JULY",2,0,"medium_poverty",2
"891","2009","West Bank and Gaza","Income share held by highest 20%",42.6,"FEBRUARY",9,0,"medium_poverty",9
"892","2009","West Bank and Gaza","Income share held by highest 20%",42.6,"MAY",6,1,"medium_poverty",7
"893","2009","West Bank and Gaza","Income share held by highest 20%",42.6,"APRIL",6,1,"medium_poverty",7
"894","2009","West Bank and Gaza","Income share held by highest 20%",42.6,"MARCH",9,0,"medium_poverty",9
"895","2009","West Bank and Gaza","Income share held by highest 20%",42.6,"OCTOBER",0,0,"medium_poverty",0
"896","2009","West Bank and Gaza","Income share held by highest 20%",42.6,"JANUARY",978,6,"medium_poverty",984
"897","2009","West Bank and Gaza","Income share held by highest 20%",42.6,"DECEMBER",6,1,"medium_poverty",7
"898","2009","West Bank and Gaza","Income share held by highest 20%",42.6,"NOVEMBER",1,0,"medium_poverty",1
"899","2009","West Bank and Gaza","Income share held by highest 20%",42.6,"AUGUST",6,0,"medium_poverty",6
"900","2009","West Bank and Gaza","Income share held by highest 20%",42.6,"SEPTEMBER",9,0,"medium_poverty",9
"901","2009","West Bank and Gaza","Income share held by lowest 10%",3.2,"JUNE",4,0,"high_poverty",4
"902","2009","West Bank and Gaza","Income share held by lowest 10%",3.2,"JULY",2,0,"high_poverty",2
"903","2009","West Bank and Gaza","Income share held by lowest 10%",3.2,"FEBRUARY",9,0,"high_poverty",9
"904","2009","West Bank and Gaza","Income share held by lowest 10%",3.2,"MAY",6,1,"high_poverty",7
"905","2009","West Bank and Gaza","Income share held by lowest 10%",3.2,"APRIL",6,1,"high_poverty",7
"906","2009","West Bank and Gaza","Income share held by lowest 10%",3.2,"MARCH",9,0,"high_poverty",9
"907","2009","West Bank and Gaza","Income share held by lowest 10%",3.2,"OCTOBER",0,0,"high_poverty",0
"908","2009","West Bank and Gaza","Income share held by lowest 10%",3.2,"JANUARY",978,6,"high_poverty",984
"909","2009","West Bank and Gaza","Income share held by lowest 10%",3.2,"DECEMBER",6,1,"high_poverty",7
"910","2009","West Bank and Gaza","Income share held by lowest 10%",3.2,"NOVEMBER",1,0,"high_poverty",1
"911","2009","West Bank and Gaza","Income share held by lowest 10%",3.2,"AUGUST",6,0,"high_poverty",6
"912","2009","West Bank and Gaza","Income share held by lowest 10%",3.2,"SEPTEMBER",9,0,"high_poverty",9
"913","2009","West Bank and Gaza","Proportion of people living below 50 percent of median income (%)",9.6,"JUNE",4,0,"medium_poverty",4
"914","2009","West Bank and Gaza","Proportion of people living below 50 percent of median income (%)",9.6,"JULY",2,0,"medium_poverty",2
"915","2009","West Bank and Gaza","Proportion of people living below 50 percent of median income (%)",9.6,"FEBRUARY",9,0,"medium_poverty",9
"916","2009","West Bank and Gaza","Proportion of people living below 50 percent of median income (%)",9.6,"MAY",6,1,"medium_poverty",7
"917","2009","West Bank and Gaza","Proportion of people living below 50 percent of median income (%)",9.6,"APRIL",6,1,"medium_poverty",7
"918","2009","West Bank and Gaza","Proportion of people living below 50 percent of median income (%)",9.6,"MARCH",9,0,"medium_poverty",9
"919","2009","West Bank and Gaza","Proportion of people living below 50 percent of median income (%)",9.6,"OCTOBER",0,0,"medium_poverty",0
"920","2009","West Bank and Gaza","Proportion of people living below 50 percent of median income (%)",9.6,"JANUARY",978,6,"medium_poverty",984
"921","2009","West Bank and Gaza","Proportion of people living below 50 percent of median income (%)",9.6,"DECEMBER",6,1,"medium_poverty",7
"922","2009","West Bank and Gaza","Proportion of people living below 50 percent of median income (%)",9.6,"NOVEMBER",1,0,"medium_poverty",1
"923","2009","West Bank and Gaza","Proportion of people living below 50 percent of median income (%)",9.6,"AUGUST",6,0,"medium_poverty",6
"924","2009","West Bank and Gaza","Proportion of people living below 50 percent of median income (%)",9.6,"SEPTEMBER",9,0,"medium_poverty",9
"925","2009","West Bank and Gaza","Poverty headcount ratio at $6.85 a day (2017 PPP) (% of population)",18.2,"JUNE",4,0,"high_poverty",4
"926","2009","West Bank and Gaza","Poverty headcount ratio at $6.85 a day (2017 PPP) (% of population)",18.2,"JULY",2,0,"high_poverty",2
"927","2009","West Bank and Gaza","Poverty headcount ratio at $6.85 a day (2017 PPP) (% of population)",18.2,"FEBRUARY",9,0,"high_poverty",9
"928","2009","West Bank and Gaza","Poverty headcount ratio at $6.85 a day (2017 PPP) (% of population)",18.2,"MAY",6,1,"high_poverty",7
"929","2009","West Bank and Gaza","Poverty headcount ratio at $6.85 a day (2017 PPP) (% of population)",18.2,"APRIL",6,1,"high_poverty",7
"930","2009","West Bank and Gaza","Poverty headcount ratio at $6.85 a day (2017 PPP) (% of population)",18.2,"MARCH",9,0,"high_poverty",9
"931","2009","West Bank and Gaza","Poverty headcount ratio at $6.85 a day (2017 PPP) (% of population)",18.2,"OCTOBER",0,0,"high_poverty",0
"932","2009","West Bank and Gaza","Poverty headcount ratio at $6.85 a day (2017 PPP) (% of population)",18.2,"JANUARY",978,6,"high_poverty",984
"933","2009","West Bank and Gaza","Poverty headcount ratio at $6.85 a day (2017 PPP) (% of population)",18.2,"DECEMBER",6,1,"high_poverty",7
"934","2009","West Bank and Gaza","Poverty headcount ratio at $6.85 a day (2017 PPP) (% of population)",18.2,"NOVEMBER",1,0,"high_poverty",1
"935","2009","West Bank and Gaza","Poverty headcount ratio at $6.85 a day (2017 PPP) (% of population)",18.2,"AUGUST",6,0,"high_poverty",6
"936","2009","West Bank and Gaza","Poverty headcount ratio at $6.85 a day (2017 PPP) (% of population)",18.2,"SEPTEMBER",9,0,"high_poverty",9
"937","2009","West Bank and Gaza","Income share held by third 20%",15.9,"JUNE",4,0,"medium_poverty",4
"938","2009","West Bank and Gaza","Income share held by third 20%",15.9,"JULY",2,0,"medium_poverty",2
"939","2009","West Bank and Gaza","Income share held by third 20%",15.9,"FEBRUARY",9,0,"medium_poverty",9
"940","2009","West Bank and Gaza","Income share held by third 20%",15.9,"MAY",6,1,"medium_poverty",7
"941","2009","West Bank and Gaza","Income share held by third 20%",15.9,"APRIL",6,1,"medium_poverty",7
"942","2009","West Bank and Gaza","Income share held by third 20%",15.9,"MARCH",9,0,"medium_poverty",9
"943","2009","West Bank and Gaza","Income share held by third 20%",15.9,"OCTOBER",0,0,"medium_poverty",0
"944","2009","West Bank and Gaza","Income share held by third 20%",15.9,"JANUARY",978,6,"medium_poverty",984
"945","2009","West Bank and Gaza","Income share held by third 20%",15.9,"DECEMBER",6,1,"medium_poverty",7
"946","2009","West Bank and Gaza","Income share held by third 20%",15.9,"NOVEMBER",1,0,"medium_poverty",1
"947","2009","West Bank and Gaza","Income share held by third 20%",15.9,"AUGUST",6,0,"medium_poverty",6
"948","2009","West Bank and Gaza","Income share held by third 20%",15.9,"SEPTEMBER",9,0,"medium_poverty",9
"949","2010","West Bank and Gaza","Income share held by third 20%",15.7,"APRIL",5,0,"medium_poverty",5
"950","2010","West Bank and Gaza","Income share held by third 20%",15.7,"AUGUST",2,4,"medium_poverty",6
"951","2010","West Bank and Gaza","Income share held by third 20%",15.7,"JULY",5,0,"medium_poverty",5
"952","2010","West Bank and Gaza","Income share held by third 20%",15.7,"JUNE",15,1,"medium_poverty",16
"953","2010","West Bank and Gaza","Income share held by third 20%",15.7,"MAY",2,0,"medium_poverty",2
"954","2010","West Bank and Gaza","Income share held by third 20%",15.7,"MARCH",8,2,"medium_poverty",10
"955","2010","West Bank and Gaza","Income share held by third 20%",15.7,"FEBRUARY",2,2,"medium_poverty",4
"956","2010","West Bank and Gaza","Income share held by third 20%",15.7,"JANUARY",8,0,"medium_poverty",8
"957","2010","West Bank and Gaza","Income share held by third 20%",15.7,"OCTOBER",6,0,"medium_poverty",6
"958","2010","West Bank and Gaza","Income share held by third 20%",15.7,"SEPTEMBER",13,0,"medium_poverty",13
"959","2010","West Bank and Gaza","Income share held by third 20%",15.7,"DECEMBER",13,0,"medium_poverty",13
"960","2010","West Bank and Gaza","Income share held by third 20%",15.7,"NOVEMBER",3,0,"medium_poverty",3
"961","2010","West Bank and Gaza","Population living in slums (% of urban population)",25.25772,"APRIL",5,0,"medium_poverty",5
"962","2010","West Bank and Gaza","Population living in slums (% of urban population)",25.25772,"AUGUST",2,4,"medium_poverty",6
"963","2010","West Bank and Gaza","Population living in slums (% of urban population)",25.25772,"JULY",5,0,"medium_poverty",5
"964","2010","West Bank and Gaza","Population living in slums (% of urban population)",25.25772,"JUNE",15,1,"medium_poverty",16
"965","2010","West Bank and Gaza","Population living in slums (% of urban population)",25.25772,"MAY",2,0,"medium_poverty",2
"966","2010","West Bank and Gaza","Population living in slums (% of urban population)",25.25772,"MARCH",8,2,"medium_poverty",10
"967","2010","West Bank and Gaza","Population living in slums (% of urban population)",25.25772,"FEBRUARY",2,2,"medium_poverty",4
"968","2010","West Bank and Gaza","Population living in slums (% of urban population)",25.25772,"JANUARY",8,0,"medium_poverty",8
"969","2010","West Bank and Gaza","Population living in slums (% of urban population)",25.25772,"OCTOBER",6,0,"medium_poverty",6
"970","2010","West Bank and Gaza","Population living in slums (% of urban population)",25.25772,"SEPTEMBER",13,0,"medium_poverty",13
"971","2010","West Bank and Gaza","Population living in slums (% of urban population)",25.25772,"DECEMBER",13,0,"medium_poverty",13
"972","2010","West Bank and Gaza","Population living in slums (% of urban population)",25.25772,"NOVEMBER",3,0,"medium_poverty",3
"973","2010","West Bank and Gaza","Income share held by lowest 20%",7.5,"APRIL",5,0,"high_poverty",5
"974","2010","West Bank and Gaza","Income share held by lowest 20%",7.5,"AUGUST",2,4,"high_poverty",6
"975","2010","West Bank and Gaza","Income share held by lowest 20%",7.5,"JULY",5,0,"high_poverty",5
"976","2010","West Bank and Gaza","Income share held by lowest 20%",7.5,"JUNE",15,1,"high_poverty",16
"977","2010","West Bank and Gaza","Income share held by lowest 20%",7.5,"MAY",2,0,"high_poverty",2
"978","2010","West Bank and Gaza","Income share held by lowest 20%",7.5,"MARCH",8,2,"high_poverty",10
"979","2010","West Bank and Gaza","Income share held by lowest 20%",7.5,"FEBRUARY",2,2,"high_poverty",4
"980","2010","West Bank and Gaza","Income share held by lowest 20%",7.5,"JANUARY",8,0,"high_poverty",8
"981","2010","West Bank and Gaza","Income share held by lowest 20%",7.5,"OCTOBER",6,0,"high_poverty",6
"982","2010","West Bank and Gaza","Income share held by lowest 20%",7.5,"SEPTEMBER",13,0,"high_poverty",13
"983","2010","West Bank and Gaza","Income share held by lowest 20%",7.5,"DECEMBER",13,0,"high_poverty",13
"984","2010","West Bank and Gaza","Income share held by lowest 20%",7.5,"NOVEMBER",3,0,"high_poverty",3
"985","2010","West Bank and Gaza","Proportion of people living below 50 percent of median income (%)",10.2,"APRIL",5,0,"medium_poverty",5
"986","2010","West Bank and Gaza","Proportion of people living below 50 percent of median income (%)",10.2,"AUGUST",2,4,"medium_poverty",6
"987","2010","West Bank and Gaza","Proportion of people living below 50 percent of median income (%)",10.2,"JULY",5,0,"medium_poverty",5
"988","2010","West Bank and Gaza","Proportion of people living below 50 percent of median income (%)",10.2,"JUNE",15,1,"medium_poverty",16
"989","2010","West Bank and Gaza","Proportion of people living below 50 percent of median income (%)",10.2,"MAY",2,0,"medium_poverty",2
"990","2010","West Bank and Gaza","Proportion of people living below 50 percent of median income (%)",10.2,"MARCH",8,2,"medium_poverty",10
"991","2010","West Bank and Gaza","Proportion of people living below 50 percent of median income (%)",10.2,"FEBRUARY",2,2,"medium_poverty",4
"992","2010","West Bank and Gaza","Proportion of people living below 50 percent of median income (%)",10.2,"JANUARY",8,0,"medium_poverty",8
"993","2010","West Bank and Gaza","Proportion of people living below 50 percent of median income (%)",10.2,"OCTOBER",6,0,"medium_poverty",6
"994","2010","West Bank and Gaza","Proportion of people living below 50 percent of median income (%)",10.2,"SEPTEMBER",13,0,"medium_poverty",13
"995","2010","West Bank and Gaza","Proportion of people living below 50 percent of median income (%)",10.2,"DECEMBER",13,0,"medium_poverty",13
"996","2010","West Bank and Gaza","Proportion of people living below 50 percent of median income (%)",10.2,"NOVEMBER",3,0,"medium_poverty",3
"997","2010","West Bank and Gaza","Poverty headcount ratio at national poverty lines (% of population)",25.7,"APRIL",5,0,"medium_poverty",5
"998","2010","West Bank and Gaza","Poverty headcount ratio at national poverty lines (% of population)",25.7,"AUGUST",2,4,"medium_poverty",6
"999","2010","West Bank and Gaza","Poverty headcount ratio at national poverty lines (% of population)",25.7,"JULY",5,0,"medium_poverty",5
"1000","2010","West Bank and Gaza","Poverty headcount ratio at national poverty lines (% of population)",25.7,"JUNE",15,1,"medium_poverty",16
"1001","2010","West Bank and Gaza","Poverty headcount ratio at national poverty lines (% of population)",25.7,"MAY",2,0,"medium_poverty",2
"1002","2010","West Bank and Gaza","Poverty headcount ratio at national poverty lines (% of population)",25.7,"MARCH",8,2,"medium_poverty",10
"1003","2010","West Bank and Gaza","Poverty headcount ratio at national poverty lines (% of population)",25.7,"FEBRUARY",2,2,"medium_poverty",4
"1004","2010","West Bank and Gaza","Poverty headcount ratio at national poverty lines (% of population)",25.7,"JANUARY",8,0,"medium_poverty",8
"1005","2010","West Bank and Gaza","Poverty headcount ratio at national poverty lines (% of population)",25.7,"OCTOBER",6,0,"medium_poverty",6
"1006","2010","West Bank and Gaza","Poverty headcount ratio at national poverty lines (% of population)",25.7,"SEPTEMBER",13,0,"medium_poverty",13
"1007","2010","West Bank and Gaza","Poverty headcount ratio at national poverty lines (% of population)",25.7,"DECEMBER",13,0,"medium_poverty",13
"1008","2010","West Bank and Gaza","Poverty headcount ratio at national poverty lines (% of population)",25.7,"NOVEMBER",3,0,"medium_poverty",3
"1009","2010","West Bank and Gaza","Poverty gap at $6.85 a day (2017 PPP) (%)",4.4,"APRIL",5,0,"high_poverty",5
"1010","2010","West Bank and Gaza","Poverty gap at $6.85 a day (2017 PPP) (%)",4.4,"AUGUST",2,4,"high_poverty",6
"1011","2010","West Bank and Gaza","Poverty gap at $6.85 a day (2017 PPP) (%)",4.4,"JULY",5,0,"high_poverty",5
"1012","2010","West Bank and Gaza","Poverty gap at $6.85 a day (2017 PPP) (%)",4.4,"JUNE",15,1,"high_poverty",16
"1013","2010","West Bank and Gaza","Poverty gap at $6.85 a day (2017 PPP) (%)",4.4,"MAY",2,0,"high_poverty",2
"1014","2010","West Bank and Gaza","Poverty gap at $6.85 a day (2017 PPP) (%)",4.4,"MARCH",8,2,"high_poverty",10
"1015","2010","West Bank and Gaza","Poverty gap at $6.85 a day (2017 PPP) (%)",4.4,"FEBRUARY",2,2,"high_poverty",4
"1016","2010","West Bank and Gaza","Poverty gap at $6.85 a day (2017 PPP) (%)",4.4,"JANUARY",8,0,"high_poverty",8
"1017","2010","West Bank and Gaza","Poverty gap at $6.85 a day (2017 PPP) (%)",4.4,"OCTOBER",6,0,"high_poverty",6
"1018","2010","West Bank and Gaza","Poverty gap at $6.85 a day (2017 PPP) (%)",4.4,"SEPTEMBER",13,0,"high_poverty",13
"1019","2010","West Bank and Gaza","Poverty gap at $6.85 a day (2017 PPP) (%)",4.4,"DECEMBER",13,0,"high_poverty",13
"1020","2010","West Bank and Gaza","Poverty gap at $6.85 a day (2017 PPP) (%)",4.4,"NOVEMBER",3,0,"high_poverty",3
"1021","2010","West Bank and Gaza","Income share held by second 20%",11.7,"APRIL",5,0,"medium_poverty",5
"1022","2010","West Bank and Gaza","Income share held by second 20%",11.7,"AUGUST",2,4,"medium_poverty",6
"1023","2010","West Bank and Gaza","Income share held by second 20%",11.7,"JULY",5,0,"medium_poverty",5
"1024","2010","West Bank and Gaza","Income share held by second 20%",11.7,"JUNE",15,1,"medium_poverty",16
"1025","2010","West Bank and Gaza","Income share held by second 20%",11.7,"MAY",2,0,"medium_poverty",2
"1026","2010","West Bank and Gaza","Income share held by second 20%",11.7,"MARCH",8,2,"medium_poverty",10
"1027","2010","West Bank and Gaza","Income share held by second 20%",11.7,"FEBRUARY",2,2,"medium_poverty",4
"1028","2010","West Bank and Gaza","Income share held by second 20%",11.7,"JANUARY",8,0,"medium_poverty",8
"1029","2010","West Bank and Gaza","Income share held by second 20%",11.7,"OCTOBER",6,0,"medium_poverty",6
"1030","2010","West Bank and Gaza","Income share held by second 20%",11.7,"SEPTEMBER",13,0,"medium_poverty",13
"1031","2010","West Bank and Gaza","Income share held by second 20%",11.7,"DECEMBER",13,0,"medium_poverty",13
"1032","2010","West Bank and Gaza","Income share held by second 20%",11.7,"NOVEMBER",3,0,"medium_poverty",3
"1033","2010","West Bank and Gaza","Income share held by highest 10%",27.8,"APRIL",5,0,"medium_poverty",5
"1034","2010","West Bank and Gaza","Income share held by highest 10%",27.8,"AUGUST",2,4,"medium_poverty",6
"1035","2010","West Bank and Gaza","Income share held by highest 10%",27.8,"JULY",5,0,"medium_poverty",5
"1036","2010","West Bank and Gaza","Income share held by highest 10%",27.8,"JUNE",15,1,"medium_poverty",16
"1037","2010","West Bank and Gaza","Income share held by highest 10%",27.8,"MAY",2,0,"medium_poverty",2
"1038","2010","West Bank and Gaza","Income share held by highest 10%",27.8,"MARCH",8,2,"medium_poverty",10
"1039","2010","West Bank and Gaza","Income share held by highest 10%",27.8,"FEBRUARY",2,2,"medium_poverty",4
"1040","2010","West Bank and Gaza","Income share held by highest 10%",27.8,"JANUARY",8,0,"medium_poverty",8
"1041","2010","West Bank and Gaza","Income share held by highest 10%",27.8,"OCTOBER",6,0,"medium_poverty",6
"1042","2010","West Bank and Gaza","Income share held by highest 10%",27.8,"SEPTEMBER",13,0,"medium_poverty",13
"1043","2010","West Bank and Gaza","Income share held by highest 10%",27.8,"DECEMBER",13,0,"medium_poverty",13
"1044","2010","West Bank and Gaza","Income share held by highest 10%",27.8,"NOVEMBER",3,0,"medium_poverty",3
"1045","2010","West Bank and Gaza","Income share held by fourth 20%",21.9,"APRIL",5,0,"medium_poverty",5
"1046","2010","West Bank and Gaza","Income share held by fourth 20%",21.9,"AUGUST",2,4,"medium_poverty",6
"1047","2010","West Bank and Gaza","Income share held by fourth 20%",21.9,"JULY",5,0,"medium_poverty",5
"1048","2010","West Bank and Gaza","Income share held by fourth 20%",21.9,"JUNE",15,1,"medium_poverty",16
"1049","2010","West Bank and Gaza","Income share held by fourth 20%",21.9,"MAY",2,0,"medium_poverty",2
"1050","2010","West Bank and Gaza","Income share held by fourth 20%",21.9,"MARCH",8,2,"medium_poverty",10
"1051","2010","West Bank and Gaza","Income share held by fourth 20%",21.9,"FEBRUARY",2,2,"medium_poverty",4
"1052","2010","West Bank and Gaza","Income share held by fourth 20%",21.9,"JANUARY",8,0,"medium_poverty",8
"1053","2010","West Bank and Gaza","Income share held by fourth 20%",21.9,"OCTOBER",6,0,"medium_poverty",6
"1054","2010","West Bank and Gaza","Income share held by fourth 20%",21.9,"SEPTEMBER",13,0,"medium_poverty",13
"1055","2010","West Bank and Gaza","Income share held by fourth 20%",21.9,"DECEMBER",13,0,"medium_poverty",13
"1056","2010","West Bank and Gaza","Income share held by fourth 20%",21.9,"NOVEMBER",3,0,"medium_poverty",3
"1057","2010","West Bank and Gaza","Income share held by highest 20%",43.2,"APRIL",5,0,"medium_poverty",5
"1058","2010","West Bank and Gaza","Income share held by highest 20%",43.2,"AUGUST",2,4,"medium_poverty",6
"1059","2010","West Bank and Gaza","Income share held by highest 20%",43.2,"JULY",5,0,"medium_poverty",5
"1060","2010","West Bank and Gaza","Income share held by highest 20%",43.2,"JUNE",15,1,"medium_poverty",16
"1061","2010","West Bank and Gaza","Income share held by highest 20%",43.2,"MAY",2,0,"medium_poverty",2
"1062","2010","West Bank and Gaza","Income share held by highest 20%",43.2,"MARCH",8,2,"medium_poverty",10
"1063","2010","West Bank and Gaza","Income share held by highest 20%",43.2,"FEBRUARY",2,2,"medium_poverty",4
"1064","2010","West Bank and Gaza","Income share held by highest 20%",43.2,"JANUARY",8,0,"medium_poverty",8
"1065","2010","West Bank and Gaza","Income share held by highest 20%",43.2,"OCTOBER",6,0,"medium_poverty",6
"1066","2010","West Bank and Gaza","Income share held by highest 20%",43.2,"SEPTEMBER",13,0,"medium_poverty",13
"1067","2010","West Bank and Gaza","Income share held by highest 20%",43.2,"DECEMBER",13,0,"medium_poverty",13
"1068","2010","West Bank and Gaza","Income share held by highest 20%",43.2,"NOVEMBER",3,0,"medium_poverty",3
"1069","2010","West Bank and Gaza","Poverty headcount ratio at $6.85 a day (2017 PPP) (% of population)",18.9,"APRIL",5,0,"high_poverty",5
"1070","2010","West Bank and Gaza","Poverty headcount ratio at $6.85 a day (2017 PPP) (% of population)",18.9,"AUGUST",2,4,"high_poverty",6
"1071","2010","West Bank and Gaza","Poverty headcount ratio at $6.85 a day (2017 PPP) (% of population)",18.9,"JULY",5,0,"high_poverty",5
"1072","2010","West Bank and Gaza","Poverty headcount ratio at $6.85 a day (2017 PPP) (% of population)",18.9,"JUNE",15,1,"high_poverty",16
"1073","2010","West Bank and Gaza","Poverty headcount ratio at $6.85 a day (2017 PPP) (% of population)",18.9,"MAY",2,0,"high_poverty",2
"1074","2010","West Bank and Gaza","Poverty headcount ratio at $6.85 a day (2017 PPP) (% of population)",18.9,"MARCH",8,2,"high_poverty",10
"1075","2010","West Bank and Gaza","Poverty headcount ratio at $6.85 a day (2017 PPP) (% of population)",18.9,"FEBRUARY",2,2,"high_poverty",4
"1076","2010","West Bank and Gaza","Poverty headcount ratio at $6.85 a day (2017 PPP) (% of population)",18.9,"JANUARY",8,0,"high_poverty",8
"1077","2010","West Bank and Gaza","Poverty headcount ratio at $6.85 a day (2017 PPP) (% of population)",18.9,"OCTOBER",6,0,"high_poverty",6
"1078","2010","West Bank and Gaza","Poverty headcount ratio at $6.85 a day (2017 PPP) (% of population)",18.9,"SEPTEMBER",13,0,"high_poverty",13
"1079","2010","West Bank and Gaza","Poverty headcount ratio at $6.85 a day (2017 PPP) (% of population)",18.9,"DECEMBER",13,0,"high_poverty",13
"1080","2010","West Bank and Gaza","Poverty headcount ratio at $6.85 a day (2017 PPP) (% of population)",18.9,"NOVEMBER",3,0,"high_poverty",3
"1081","2010","West Bank and Gaza","Poverty gap at $2.15 a day (2017 PPP) (%)",0,"APRIL",5,0,"high_poverty",5
"1082","2010","West Bank and Gaza","Poverty gap at $2.15 a day (2017 PPP) (%)",0,"AUGUST",2,4,"high_poverty",6
"1083","2010","West Bank and Gaza","Poverty gap at $2.15 a day (2017 PPP) (%)",0,"JULY",5,0,"high_poverty",5
"1084","2010","West Bank and Gaza","Poverty gap at $2.15 a day (2017 PPP) (%)",0,"JUNE",15,1,"high_poverty",16
"1085","2010","West Bank and Gaza","Poverty gap at $2.15 a day (2017 PPP) (%)",0,"MAY",2,0,"high_poverty",2
"1086","2010","West Bank and Gaza","Poverty gap at $2.15 a day (2017 PPP) (%)",0,"MARCH",8,2,"high_poverty",10
"1087","2010","West Bank and Gaza","Poverty gap at $2.15 a day (2017 PPP) (%)",0,"FEBRUARY",2,2,"high_poverty",4
"1088","2010","West Bank and Gaza","Poverty gap at $2.15 a day (2017 PPP) (%)",0,"JANUARY",8,0,"high_poverty",8
"1089","2010","West Bank and Gaza","Poverty gap at $2.15 a day (2017 PPP) (%)",0,"OCTOBER",6,0,"high_poverty",6
"1090","2010","West Bank and Gaza","Poverty gap at $2.15 a day (2017 PPP) (%)",0,"SEPTEMBER",13,0,"high_poverty",13
"1091","2010","West Bank and Gaza","Poverty gap at $2.15 a day (2017 PPP) (%)",0,"DECEMBER",13,0,"high_poverty",13
"1092","2010","West Bank and Gaza","Poverty gap at $2.15 a day (2017 PPP) (%)",0,"NOVEMBER",3,0,"high_poverty",3
"1093","2010","West Bank and Gaza","Poverty headcount ratio at $3.65 a day (2017 PPP) (% of population)",2,"APRIL",5,0,"high_poverty",5
"1094","2010","West Bank and Gaza","Poverty headcount ratio at $3.65 a day (2017 PPP) (% of population)",2,"AUGUST",2,4,"high_poverty",6
"1095","2010","West Bank and Gaza","Poverty headcount ratio at $3.65 a day (2017 PPP) (% of population)",2,"JULY",5,0,"high_poverty",5
"1096","2010","West Bank and Gaza","Poverty headcount ratio at $3.65 a day (2017 PPP) (% of population)",2,"JUNE",15,1,"high_poverty",16
"1097","2010","West Bank and Gaza","Poverty headcount ratio at $3.65 a day (2017 PPP) (% of population)",2,"MAY",2,0,"high_poverty",2
"1098","2010","West Bank and Gaza","Poverty headcount ratio at $3.65 a day (2017 PPP) (% of population)",2,"MARCH",8,2,"high_poverty",10
"1099","2010","West Bank and Gaza","Poverty headcount ratio at $3.65 a day (2017 PPP) (% of population)",2,"FEBRUARY",2,2,"high_poverty",4
"1100","2010","West Bank and Gaza","Poverty headcount ratio at $3.65 a day (2017 PPP) (% of population)",2,"JANUARY",8,0,"high_poverty",8
"1101","2010","West Bank and Gaza","Poverty headcount ratio at $3.65 a day (2017 PPP) (% of population)",2,"OCTOBER",6,0,"high_poverty",6
"1102","2010","West Bank and Gaza","Poverty headcount ratio at $3.65 a day (2017 PPP) (% of population)",2,"SEPTEMBER",13,0,"high_poverty",13
"1103","2010","West Bank and Gaza","Poverty headcount ratio at $3.65 a day (2017 PPP) (% of population)",2,"DECEMBER",13,0,"high_poverty",13
"1104","2010","West Bank and Gaza","Poverty headcount ratio at $3.65 a day (2017 PPP) (% of population)",2,"NOVEMBER",3,0,"high_poverty",3
"1105","2010","West Bank and Gaza","Poverty headcount ratio at $2.15 a day (2017 PPP) (% of population)",0,"APRIL",5,0,"high_poverty",5
"1106","2010","West Bank and Gaza","Poverty headcount ratio at $2.15 a day (2017 PPP) (% of population)",0,"AUGUST",2,4,"high_poverty",6
"1107","2010","West Bank and Gaza","Poverty headcount ratio at $2.15 a day (2017 PPP) (% of population)",0,"JULY",5,0,"high_poverty",5
"1108","2010","West Bank and Gaza","Poverty headcount ratio at $2.15 a day (2017 PPP) (% of population)",0,"JUNE",15,1,"high_poverty",16
"1109","2010","West Bank and Gaza","Poverty headcount ratio at $2.15 a day (2017 PPP) (% of population)",0,"MAY",2,0,"high_poverty",2
"1110","2010","West Bank and Gaza","Poverty headcount ratio at $2.15 a day (2017 PPP) (% of population)",0,"MARCH",8,2,"high_poverty",10
"1111","2010","West Bank and Gaza","Poverty headcount ratio at $2.15 a day (2017 PPP) (% of population)",0,"FEBRUARY",2,2,"high_poverty",4
"1112","2010","West Bank and Gaza","Poverty headcount ratio at $2.15 a day (2017 PPP) (% of population)",0,"JANUARY",8,0,"high_poverty",8
"1113","2010","West Bank and Gaza","Poverty headcount ratio at $2.15 a day (2017 PPP) (% of population)",0,"OCTOBER",6,0,"high_poverty",6
"1114","2010","West Bank and Gaza","Poverty headcount ratio at $2.15 a day (2017 PPP) (% of population)",0,"SEPTEMBER",13,0,"high_poverty",13
"1115","2010","West Bank and Gaza","Poverty headcount ratio at $2.15 a day (2017 PPP) (% of population)",0,"DECEMBER",13,0,"high_poverty",13
"1116","2010","West Bank and Gaza","Poverty headcount ratio at $2.15 a day (2017 PPP) (% of population)",0,"NOVEMBER",3,0,"high_poverty",3
"1117","2010","West Bank and Gaza","Gini index",35.3,"APRIL",5,0,"medium_poverty",5
"1118","2010","West Bank and Gaza","Gini index",35.3,"AUGUST",2,4,"medium_poverty",6
"1119","2010","West Bank and Gaza","Gini index",35.3,"JULY",5,0,"medium_poverty",5
"1120","2010","West Bank and Gaza","Gini index",35.3,"JUNE",15,1,"medium_poverty",16
"1121","2010","West Bank and Gaza","Gini index",35.3,"MAY",2,0,"medium_poverty",2
"1122","2010","West Bank and Gaza","Gini index",35.3,"MARCH",8,2,"medium_poverty",10
"1123","2010","West Bank and Gaza","Gini index",35.3,"FEBRUARY",2,2,"medium_poverty",4
"1124","2010","West Bank and Gaza","Gini index",35.3,"JANUARY",8,0,"medium_poverty",8
"1125","2010","West Bank and Gaza","Gini index",35.3,"OCTOBER",6,0,"medium_poverty",6
"1126","2010","West Bank and Gaza","Gini index",35.3,"SEPTEMBER",13,0,"medium_poverty",13
"1127","2010","West Bank and Gaza","Gini index",35.3,"DECEMBER",13,0,"medium_poverty",13
"1128","2010","West Bank and Gaza","Gini index",35.3,"NOVEMBER",3,0,"medium_poverty",3
"1129","2010","West Bank and Gaza","Income share held by lowest 10%",3.1,"APRIL",5,0,"high_poverty",5
"1130","2010","West Bank and Gaza","Income share held by lowest 10%",3.1,"AUGUST",2,4,"high_poverty",6
"1131","2010","West Bank and Gaza","Income share held by lowest 10%",3.1,"JULY",5,0,"high_poverty",5
"1132","2010","West Bank and Gaza","Income share held by lowest 10%",3.1,"JUNE",15,1,"high_poverty",16
"1133","2010","West Bank and Gaza","Income share held by lowest 10%",3.1,"MAY",2,0,"high_poverty",2
"1134","2010","West Bank and Gaza","Income share held by lowest 10%",3.1,"MARCH",8,2,"high_poverty",10
"1135","2010","West Bank and Gaza","Income share held by lowest 10%",3.1,"FEBRUARY",2,2,"high_poverty",4
"1136","2010","West Bank and Gaza","Income share held by lowest 10%",3.1,"JANUARY",8,0,"high_poverty",8
"1137","2010","West Bank and Gaza","Income share held by lowest 10%",3.1,"OCTOBER",6,0,"high_poverty",6
"1138","2010","West Bank and Gaza","Income share held by lowest 10%",3.1,"SEPTEMBER",13,0,"high_poverty",13
"1139","2010","West Bank and Gaza","Income share held by lowest 10%",3.1,"DECEMBER",13,0,"high_poverty",13
"1140","2010","West Bank and Gaza","Income share held by lowest 10%",3.1,"NOVEMBER",3,0,"high_poverty",3
"1141","2010","West Bank and Gaza","Poverty gap at $3.65 a day (2017 PPP) (%)",0.3,"APRIL",5,0,"high_poverty",5
"1142","2010","West Bank and Gaza","Poverty gap at $3.65 a day (2017 PPP) (%)",0.3,"AUGUST",2,4,"high_poverty",6
"1143","2010","West Bank and Gaza","Poverty gap at $3.65 a day (2017 PPP) (%)",0.3,"JULY",5,0,"high_poverty",5
"1144","2010","West Bank and Gaza","Poverty gap at $3.65 a day (2017 PPP) (%)",0.3,"JUNE",15,1,"high_poverty",16
"1145","2010","West Bank and Gaza","Poverty gap at $3.65 a day (2017 PPP) (%)",0.3,"MAY",2,0,"high_poverty",2
"1146","2010","West Bank and Gaza","Poverty gap at $3.65 a day (2017 PPP) (%)",0.3,"MARCH",8,2,"high_poverty",10
"1147","2010","West Bank and Gaza","Poverty gap at $3.65 a day (2017 PPP) (%)",0.3,"FEBRUARY",2,2,"high_poverty",4
"1148","2010","West Bank and Gaza","Poverty gap at $3.65 a day (2017 PPP) (%)",0.3,"JANUARY",8,0,"high_poverty",8
"1149","2010","West Bank and Gaza","Poverty gap at $3.65 a day (2017 PPP) (%)",0.3,"OCTOBER",6,0,"high_poverty",6
"1150","2010","West Bank and Gaza","Poverty gap at $3.65 a day (2017 PPP) (%)",0.3,"SEPTEMBER",13,0,"high_poverty",13
"1151","2010","West Bank and Gaza","Poverty gap at $3.65 a day (2017 PPP) (%)",0.3,"DECEMBER",13,0,"high_poverty",13
"1152","2010","West Bank and Gaza","Poverty gap at $3.65 a day (2017 PPP) (%)",0.3,"NOVEMBER",3,0,"high_poverty",3
"1153","2011","West Bank and Gaza","Proportion of people living below 50 percent of median income (%)",9.9,"MARCH",15,5,"medium_poverty",20
"1154","2011","West Bank and Gaza","Proportion of people living below 50 percent of median income (%)",9.9,"FEBRUARY",6,0,"medium_poverty",6
"1155","2011","West Bank and Gaza","Proportion of people living below 50 percent of median income (%)",9.9,"JANUARY",10,0,"medium_poverty",10
"1156","2011","West Bank and Gaza","Proportion of people living below 50 percent of median income (%)",9.9,"APRIL",24,2,"medium_poverty",26
"1157","2011","West Bank and Gaza","Proportion of people living below 50 percent of median income (%)",9.9,"SEPTEMBER",2,2,"medium_poverty",4
"1158","2011","West Bank and Gaza","Proportion of people living below 50 percent of median income (%)",9.9,"DECEMBER",8,0,"medium_poverty",8
"1159","2011","West Bank and Gaza","Proportion of people living below 50 percent of median income (%)",9.9,"NOVEMBER",4,0,"medium_poverty",4
"1160","2011","West Bank and Gaza","Proportion of people living below 50 percent of median income (%)",9.9,"OCTOBER",12,0,"medium_poverty",12
"1161","2011","West Bank and Gaza","Proportion of people living below 50 percent of median income (%)",9.9,"MAY",2,0,"medium_poverty",2
"1162","2011","West Bank and Gaza","Proportion of people living below 50 percent of median income (%)",9.9,"JUNE",0,0,"medium_poverty",0
"1163","2011","West Bank and Gaza","Proportion of people living below 50 percent of median income (%)",9.9,"AUGUST",30,1,"medium_poverty",31
"1164","2011","West Bank and Gaza","Proportion of people living below 50 percent of median income (%)",9.9,"JULY",4,0,"medium_poverty",4
"1165","2011","West Bank and Gaza","Survey mean consumption or income per capita, total population (2017 PPP $ per day)",14.27,"MARCH",15,5,"low_poverty",20
"1166","2011","West Bank and Gaza","Survey mean consumption or income per capita, total population (2017 PPP $ per day)",14.27,"FEBRUARY",6,0,"low_poverty",6
"1167","2011","West Bank and Gaza","Survey mean consumption or income per capita, total population (2017 PPP $ per day)",14.27,"JANUARY",10,0,"low_poverty",10
"1168","2011","West Bank and Gaza","Survey mean consumption or income per capita, total population (2017 PPP $ per day)",14.27,"APRIL",24,2,"low_poverty",26
"1169","2011","West Bank and Gaza","Survey mean consumption or income per capita, total population (2017 PPP $ per day)",14.27,"SEPTEMBER",2,2,"low_poverty",4
"1170","2011","West Bank and Gaza","Survey mean consumption or income per capita, total population (2017 PPP $ per day)",14.27,"DECEMBER",8,0,"low_poverty",8
"1171","2011","West Bank and Gaza","Survey mean consumption or income per capita, total population (2017 PPP $ per day)",14.27,"NOVEMBER",4,0,"low_poverty",4
"1172","2011","West Bank and Gaza","Survey mean consumption or income per capita, total population (2017 PPP $ per day)",14.27,"OCTOBER",12,0,"low_poverty",12
"1173","2011","West Bank and Gaza","Survey mean consumption or income per capita, total population (2017 PPP $ per day)",14.27,"MAY",2,0,"low_poverty",2
"1174","2011","West Bank and Gaza","Survey mean consumption or income per capita, total population (2017 PPP $ per day)",14.27,"JUNE",0,0,"low_poverty",0
"1175","2011","West Bank and Gaza","Survey mean consumption or income per capita, total population (2017 PPP $ per day)",14.27,"AUGUST",30,1,"low_poverty",31
"1176","2011","West Bank and Gaza","Survey mean consumption or income per capita, total population (2017 PPP $ per day)",14.27,"JULY",4,0,"low_poverty",4
"1177","2011","West Bank and Gaza","Income share held by highest 10%",27.2,"MARCH",15,5,"medium_poverty",20
"1178","2011","West Bank and Gaza","Income share held by highest 10%",27.2,"FEBRUARY",6,0,"medium_poverty",6
"1179","2011","West Bank and Gaza","Income share held by highest 10%",27.2,"JANUARY",10,0,"medium_poverty",10
"1180","2011","West Bank and Gaza","Income share held by highest 10%",27.2,"APRIL",24,2,"medium_poverty",26
"1181","2011","West Bank and Gaza","Income share held by highest 10%",27.2,"SEPTEMBER",2,2,"medium_poverty",4
"1182","2011","West Bank and Gaza","Income share held by highest 10%",27.2,"DECEMBER",8,0,"medium_poverty",8
"1183","2011","West Bank and Gaza","Income share held by highest 10%",27.2,"NOVEMBER",4,0,"medium_poverty",4
"1184","2011","West Bank and Gaza","Income share held by highest 10%",27.2,"OCTOBER",12,0,"medium_poverty",12
"1185","2011","West Bank and Gaza","Income share held by highest 10%",27.2,"MAY",2,0,"medium_poverty",2
"1186","2011","West Bank and Gaza","Income share held by highest 10%",27.2,"JUNE",0,0,"medium_poverty",0
"1187","2011","West Bank and Gaza","Income share held by highest 10%",27.2,"AUGUST",30,1,"medium_poverty",31
"1188","2011","West Bank and Gaza","Income share held by highest 10%",27.2,"JULY",4,0,"medium_poverty",4
"1189","2011","West Bank and Gaza","Income share held by lowest 20%",7.7,"MARCH",15,5,"high_poverty",20
"1190","2011","West Bank and Gaza","Income share held by lowest 20%",7.7,"FEBRUARY",6,0,"high_poverty",6
"1191","2011","West Bank and Gaza","Income share held by lowest 20%",7.7,"JANUARY",10,0,"high_poverty",10
"1192","2011","West Bank and Gaza","Income share held by lowest 20%",7.7,"APRIL",24,2,"high_poverty",26
"1193","2011","West Bank and Gaza","Income share held by lowest 20%",7.7,"SEPTEMBER",2,2,"high_poverty",4
"1194","2011","West Bank and Gaza","Income share held by lowest 20%",7.7,"DECEMBER",8,0,"high_poverty",8
"1195","2011","West Bank and Gaza","Income share held by lowest 20%",7.7,"NOVEMBER",4,0,"high_poverty",4
"1196","2011","West Bank and Gaza","Income share held by lowest 20%",7.7,"OCTOBER",12,0,"high_poverty",12
"1197","2011","West Bank and Gaza","Income share held by lowest 20%",7.7,"MAY",2,0,"high_poverty",2
"1198","2011","West Bank and Gaza","Income share held by lowest 20%",7.7,"JUNE",0,0,"high_poverty",0
"1199","2011","West Bank and Gaza","Income share held by lowest 20%",7.7,"AUGUST",30,1,"high_poverty",31
"1200","2011","West Bank and Gaza","Income share held by lowest 20%",7.7,"JULY",4,0,"high_poverty",4
"1201","2011","West Bank and Gaza","Poverty headcount ratio at national poverty lines (% of population)",25.8,"MARCH",15,5,"medium_poverty",20
"1202","2011","West Bank and Gaza","Poverty headcount ratio at national poverty lines (% of population)",25.8,"FEBRUARY",6,0,"medium_poverty",6
"1203","2011","West Bank and Gaza","Poverty headcount ratio at national poverty lines (% of population)",25.8,"JANUARY",10,0,"medium_poverty",10
"1204","2011","West Bank and Gaza","Poverty headcount ratio at national poverty lines (% of population)",25.8,"APRIL",24,2,"medium_poverty",26
"1205","2011","West Bank and Gaza","Poverty headcount ratio at national poverty lines (% of population)",25.8,"SEPTEMBER",2,2,"medium_poverty",4
"1206","2011","West Bank and Gaza","Poverty headcount ratio at national poverty lines (% of population)",25.8,"DECEMBER",8,0,"medium_poverty",8
"1207","2011","West Bank and Gaza","Poverty headcount ratio at national poverty lines (% of population)",25.8,"NOVEMBER",4,0,"medium_poverty",4
"1208","2011","West Bank and Gaza","Poverty headcount ratio at national poverty lines (% of population)",25.8,"OCTOBER",12,0,"medium_poverty",12
"1209","2011","West Bank and Gaza","Poverty headcount ratio at national poverty lines (% of population)",25.8,"MAY",2,0,"medium_poverty",2
"1210","2011","West Bank and Gaza","Poverty headcount ratio at national poverty lines (% of population)",25.8,"JUNE",0,0,"medium_poverty",0
"1211","2011","West Bank and Gaza","Poverty headcount ratio at national poverty lines (% of population)",25.8,"AUGUST",30,1,"medium_poverty",31
"1212","2011","West Bank and Gaza","Poverty headcount ratio at national poverty lines (% of population)",25.8,"JULY",4,0,"medium_poverty",4
"1213","2011","West Bank and Gaza","Poverty gap at $3.65 a day (2017 PPP) (%)",0.3,"MARCH",15,5,"high_poverty",20
"1214","2011","West Bank and Gaza","Poverty gap at $3.65 a day (2017 PPP) (%)",0.3,"FEBRUARY",6,0,"high_poverty",6
"1215","2011","West Bank and Gaza","Poverty gap at $3.65 a day (2017 PPP) (%)",0.3,"JANUARY",10,0,"high_poverty",10
"1216","2011","West Bank and Gaza","Poverty gap at $3.65 a day (2017 PPP) (%)",0.3,"APRIL",24,2,"high_poverty",26
"1217","2011","West Bank and Gaza","Poverty gap at $3.65 a day (2017 PPP) (%)",0.3,"SEPTEMBER",2,2,"high_poverty",4
"1218","2011","West Bank and Gaza","Poverty gap at $3.65 a day (2017 PPP) (%)",0.3,"DECEMBER",8,0,"high_poverty",8
"1219","2011","West Bank and Gaza","Poverty gap at $3.65 a day (2017 PPP) (%)",0.3,"NOVEMBER",4,0,"high_poverty",4
"1220","2011","West Bank and Gaza","Poverty gap at $3.65 a day (2017 PPP) (%)",0.3,"OCTOBER",12,0,"high_poverty",12
"1221","2011","West Bank and Gaza","Poverty gap at $3.65 a day (2017 PPP) (%)",0.3,"MAY",2,0,"high_poverty",2
"1222","2011","West Bank and Gaza","Poverty gap at $3.65 a day (2017 PPP) (%)",0.3,"JUNE",0,0,"high_poverty",0
"1223","2011","West Bank and Gaza","Poverty gap at $3.65 a day (2017 PPP) (%)",0.3,"AUGUST",30,1,"high_poverty",31
"1224","2011","West Bank and Gaza","Poverty gap at $3.65 a day (2017 PPP) (%)",0.3,"JULY",4,0,"high_poverty",4
"1225","2011","West Bank and Gaza","Poverty gap at $6.85 a day (2017 PPP) (%)",4.1,"MARCH",15,5,"high_poverty",20
"1226","2011","West Bank and Gaza","Poverty gap at $6.85 a day (2017 PPP) (%)",4.1,"FEBRUARY",6,0,"high_poverty",6
"1227","2011","West Bank and Gaza","Poverty gap at $6.85 a day (2017 PPP) (%)",4.1,"JANUARY",10,0,"high_poverty",10
"1228","2011","West Bank and Gaza","Poverty gap at $6.85 a day (2017 PPP) (%)",4.1,"APRIL",24,2,"high_poverty",26
"1229","2011","West Bank and Gaza","Poverty gap at $6.85 a day (2017 PPP) (%)",4.1,"SEPTEMBER",2,2,"high_poverty",4
"1230","2011","West Bank and Gaza","Poverty gap at $6.85 a day (2017 PPP) (%)",4.1,"DECEMBER",8,0,"high_poverty",8
"1231","2011","West Bank and Gaza","Poverty gap at $6.85 a day (2017 PPP) (%)",4.1,"NOVEMBER",4,0,"high_poverty",4
"1232","2011","West Bank and Gaza","Poverty gap at $6.85 a day (2017 PPP) (%)",4.1,"OCTOBER",12,0,"high_poverty",12
"1233","2011","West Bank and Gaza","Poverty gap at $6.85 a day (2017 PPP) (%)",4.1,"MAY",2,0,"high_poverty",2
"1234","2011","West Bank and Gaza","Poverty gap at $6.85 a day (2017 PPP) (%)",4.1,"JUNE",0,0,"high_poverty",0
"1235","2011","West Bank and Gaza","Poverty gap at $6.85 a day (2017 PPP) (%)",4.1,"AUGUST",30,1,"high_poverty",31
"1236","2011","West Bank and Gaza","Poverty gap at $6.85 a day (2017 PPP) (%)",4.1,"JULY",4,0,"high_poverty",4
"1237","2011","West Bank and Gaza","Poverty headcount ratio at $6.85 a day (2017 PPP) (% of population)",17.6,"MARCH",15,5,"high_poverty",20
"1238","2011","West Bank and Gaza","Poverty headcount ratio at $6.85 a day (2017 PPP) (% of population)",17.6,"FEBRUARY",6,0,"high_poverty",6
"1239","2011","West Bank and Gaza","Poverty headcount ratio at $6.85 a day (2017 PPP) (% of population)",17.6,"JANUARY",10,0,"high_poverty",10
"1240","2011","West Bank and Gaza","Poverty headcount ratio at $6.85 a day (2017 PPP) (% of population)",17.6,"APRIL",24,2,"high_poverty",26
"1241","2011","West Bank and Gaza","Poverty headcount ratio at $6.85 a day (2017 PPP) (% of population)",17.6,"SEPTEMBER",2,2,"high_poverty",4
"1242","2011","West Bank and Gaza","Poverty headcount ratio at $6.85 a day (2017 PPP) (% of population)",17.6,"DECEMBER",8,0,"high_poverty",8
"1243","2011","West Bank and Gaza","Poverty headcount ratio at $6.85 a day (2017 PPP) (% of population)",17.6,"NOVEMBER",4,0,"high_poverty",4
"1244","2011","West Bank and Gaza","Poverty headcount ratio at $6.85 a day (2017 PPP) (% of population)",17.6,"OCTOBER",12,0,"high_poverty",12
"1245","2011","West Bank and Gaza","Poverty headcount ratio at $6.85 a day (2017 PPP) (% of population)",17.6,"MAY",2,0,"high_poverty",2
"1246","2011","West Bank and Gaza","Poverty headcount ratio at $6.85 a day (2017 PPP) (% of population)",17.6,"JUNE",0,0,"high_poverty",0
"1247","2011","West Bank and Gaza","Poverty headcount ratio at $6.85 a day (2017 PPP) (% of population)",17.6,"AUGUST",30,1,"high_poverty",31
"1248","2011","West Bank and Gaza","Poverty headcount ratio at $6.85 a day (2017 PPP) (% of population)",17.6,"JULY",4,0,"high_poverty",4
"1249","2011","West Bank and Gaza","Poverty gap at $2.15 a day (2017 PPP) (%)",0.1,"MARCH",15,5,"high_poverty",20
"1250","2011","West Bank and Gaza","Poverty gap at $2.15 a day (2017 PPP) (%)",0.1,"FEBRUARY",6,0,"high_poverty",6
"1251","2011","West Bank and Gaza","Poverty gap at $2.15 a day (2017 PPP) (%)",0.1,"JANUARY",10,0,"high_poverty",10
"1252","2011","West Bank and Gaza","Poverty gap at $2.15 a day (2017 PPP) (%)",0.1,"APRIL",24,2,"high_poverty",26
"1253","2011","West Bank and Gaza","Poverty gap at $2.15 a day (2017 PPP) (%)",0.1,"SEPTEMBER",2,2,"high_poverty",4
"1254","2011","West Bank and Gaza","Poverty gap at $2.15 a day (2017 PPP) (%)",0.1,"DECEMBER",8,0,"high_poverty",8
"1255","2011","West Bank and Gaza","Poverty gap at $2.15 a day (2017 PPP) (%)",0.1,"NOVEMBER",4,0,"high_poverty",4
"1256","2011","West Bank and Gaza","Poverty gap at $2.15 a day (2017 PPP) (%)",0.1,"OCTOBER",12,0,"high_poverty",12
"1257","2011","West Bank and Gaza","Poverty gap at $2.15 a day (2017 PPP) (%)",0.1,"MAY",2,0,"high_poverty",2
"1258","2011","West Bank and Gaza","Poverty gap at $2.15 a day (2017 PPP) (%)",0.1,"JUNE",0,0,"high_poverty",0
"1259","2011","West Bank and Gaza","Poverty gap at $2.15 a day (2017 PPP) (%)",0.1,"AUGUST",30,1,"high_poverty",31
"1260","2011","West Bank and Gaza","Poverty gap at $2.15 a day (2017 PPP) (%)",0.1,"JULY",4,0,"high_poverty",4
"1261","2011","West Bank and Gaza","Poverty headcount ratio at $2.15 a day (2017 PPP) (% of population)",0.2,"MARCH",15,5,"high_poverty",20
"1262","2011","West Bank and Gaza","Poverty headcount ratio at $2.15 a day (2017 PPP) (% of population)",0.2,"FEBRUARY",6,0,"high_poverty",6
"1263","2011","West Bank and Gaza","Poverty headcount ratio at $2.15 a day (2017 PPP) (% of population)",0.2,"JANUARY",10,0,"high_poverty",10
"1264","2011","West Bank and Gaza","Poverty headcount ratio at $2.15 a day (2017 PPP) (% of population)",0.2,"APRIL",24,2,"high_poverty",26
"1265","2011","West Bank and Gaza","Poverty headcount ratio at $2.15 a day (2017 PPP) (% of population)",0.2,"SEPTEMBER",2,2,"high_poverty",4
"1266","2011","West Bank and Gaza","Poverty headcount ratio at $2.15 a day (2017 PPP) (% of population)",0.2,"DECEMBER",8,0,"high_poverty",8
"1267","2011","West Bank and Gaza","Poverty headcount ratio at $2.15 a day (2017 PPP) (% of population)",0.2,"NOVEMBER",4,0,"high_poverty",4
"1268","2011","West Bank and Gaza","Poverty headcount ratio at $2.15 a day (2017 PPP) (% of population)",0.2,"OCTOBER",12,0,"high_poverty",12
"1269","2011","West Bank and Gaza","Poverty headcount ratio at $2.15 a day (2017 PPP) (% of population)",0.2,"MAY",2,0,"high_poverty",2
"1270","2011","West Bank and Gaza","Poverty headcount ratio at $2.15 a day (2017 PPP) (% of population)",0.2,"JUNE",0,0,"high_poverty",0
"1271","2011","West Bank and Gaza","Poverty headcount ratio at $2.15 a day (2017 PPP) (% of population)",0.2,"AUGUST",30,1,"high_poverty",31
"1272","2011","West Bank and Gaza","Poverty headcount ratio at $2.15 a day (2017 PPP) (% of population)",0.2,"JULY",4,0,"high_poverty",4
"1273","2011","West Bank and Gaza","Income share held by lowest 10%",3.1,"MARCH",15,5,"high_poverty",20
"1274","2011","West Bank and Gaza","Income share held by lowest 10%",3.1,"FEBRUARY",6,0,"high_poverty",6
"1275","2011","West Bank and Gaza","Income share held by lowest 10%",3.1,"JANUARY",10,0,"high_poverty",10
"1276","2011","West Bank and Gaza","Income share held by lowest 10%",3.1,"APRIL",24,2,"high_poverty",26
"1277","2011","West Bank and Gaza","Income share held by lowest 10%",3.1,"SEPTEMBER",2,2,"high_poverty",4
"1278","2011","West Bank and Gaza","Income share held by lowest 10%",3.1,"DECEMBER",8,0,"high_poverty",8
"1279","2011","West Bank and Gaza","Income share held by lowest 10%",3.1,"NOVEMBER",4,0,"high_poverty",4
"1280","2011","West Bank and Gaza","Income share held by lowest 10%",3.1,"OCTOBER",12,0,"high_poverty",12
"1281","2011","West Bank and Gaza","Income share held by lowest 10%",3.1,"MAY",2,0,"high_poverty",2
"1282","2011","West Bank and Gaza","Income share held by lowest 10%",3.1,"JUNE",0,0,"high_poverty",0
"1283","2011","West Bank and Gaza","Income share held by lowest 10%",3.1,"AUGUST",30,1,"high_poverty",31
"1284","2011","West Bank and Gaza","Income share held by lowest 10%",3.1,"JULY",4,0,"high_poverty",4
"1285","2011","West Bank and Gaza","Survey mean consumption or income per capita, bottom 40% of population (2017 PPP $ per day)",6.98,"MARCH",15,5,"high_poverty",20
"1286","2011","West Bank and Gaza","Survey mean consumption or income per capita, bottom 40% of population (2017 PPP $ per day)",6.98,"FEBRUARY",6,0,"high_poverty",6
"1287","2011","West Bank and Gaza","Survey mean consumption or income per capita, bottom 40% of population (2017 PPP $ per day)",6.98,"JANUARY",10,0,"high_poverty",10
"1288","2011","West Bank and Gaza","Survey mean consumption or income per capita, bottom 40% of population (2017 PPP $ per day)",6.98,"APRIL",24,2,"high_poverty",26
"1289","2011","West Bank and Gaza","Survey mean consumption or income per capita, bottom 40% of population (2017 PPP $ per day)",6.98,"SEPTEMBER",2,2,"high_poverty",4
"1290","2011","West Bank and Gaza","Survey mean consumption or income per capita, bottom 40% of population (2017 PPP $ per day)",6.98,"DECEMBER",8,0,"high_poverty",8
"1291","2011","West Bank and Gaza","Survey mean consumption or income per capita, bottom 40% of population (2017 PPP $ per day)",6.98,"NOVEMBER",4,0,"high_poverty",4
"1292","2011","West Bank and Gaza","Survey mean consumption or income per capita, bottom 40% of population (2017 PPP $ per day)",6.98,"OCTOBER",12,0,"high_poverty",12
"1293","2011","West Bank and Gaza","Survey mean consumption or income per capita, bottom 40% of population (2017 PPP $ per day)",6.98,"MAY",2,0,"high_poverty",2
"1294","2011","West Bank and Gaza","Survey mean consumption or income per capita, bottom 40% of population (2017 PPP $ per day)",6.98,"JUNE",0,0,"high_poverty",0
"1295","2011","West Bank and Gaza","Survey mean consumption or income per capita, bottom 40% of population (2017 PPP $ per day)",6.98,"AUGUST",30,1,"high_poverty",31
"1296","2011","West Bank and Gaza","Survey mean consumption or income per capita, bottom 40% of population (2017 PPP $ per day)",6.98,"JULY",4,0,"high_poverty",4
"1297","2011","West Bank and Gaza","Income share held by highest 20%",42.5,"MARCH",15,5,"medium_poverty",20
"1298","2011","West Bank and Gaza","Income share held by highest 20%",42.5,"FEBRUARY",6,0,"medium_poverty",6
"1299","2011","West Bank and Gaza","Income share held by highest 20%",42.5,"JANUARY",10,0,"medium_poverty",10
"1300","2011","West Bank and Gaza","Income share held by highest 20%",42.5,"APRIL",24,2,"medium_poverty",26
"1301","2011","West Bank and Gaza","Income share held by highest 20%",42.5,"SEPTEMBER",2,2,"medium_poverty",4
"1302","2011","West Bank and Gaza","Income share held by highest 20%",42.5,"DECEMBER",8,0,"medium_poverty",8
"1303","2011","West Bank and Gaza","Income share held by highest 20%",42.5,"NOVEMBER",4,0,"medium_poverty",4
"1304","2011","West Bank and Gaza","Income share held by highest 20%",42.5,"OCTOBER",12,0,"medium_poverty",12
"1305","2011","West Bank and Gaza","Income share held by highest 20%",42.5,"MAY",2,0,"medium_poverty",2
"1306","2011","West Bank and Gaza","Income share held by highest 20%",42.5,"JUNE",0,0,"medium_poverty",0
"1307","2011","West Bank and Gaza","Income share held by highest 20%",42.5,"AUGUST",30,1,"medium_poverty",31
"1308","2011","West Bank and Gaza","Income share held by highest 20%",42.5,"JULY",4,0,"medium_poverty",4
"1309","2011","West Bank and Gaza","Gini index",34.4,"MARCH",15,5,"medium_poverty",20
"1310","2011","West Bank and Gaza","Gini index",34.4,"FEBRUARY",6,0,"medium_poverty",6
"1311","2011","West Bank and Gaza","Gini index",34.4,"JANUARY",10,0,"medium_poverty",10
"1312","2011","West Bank and Gaza","Gini index",34.4,"APRIL",24,2,"medium_poverty",26
"1313","2011","West Bank and Gaza","Gini index",34.4,"SEPTEMBER",2,2,"medium_poverty",4
"1314","2011","West Bank and Gaza","Gini index",34.4,"DECEMBER",8,0,"medium_poverty",8
"1315","2011","West Bank and Gaza","Gini index",34.4,"NOVEMBER",4,0,"medium_poverty",4
"1316","2011","West Bank and Gaza","Gini index",34.4,"OCTOBER",12,0,"medium_poverty",12
"1317","2011","West Bank and Gaza","Gini index",34.4,"MAY",2,0,"medium_poverty",2
"1318","2011","West Bank and Gaza","Gini index",34.4,"JUNE",0,0,"medium_poverty",0
"1319","2011","West Bank and Gaza","Gini index",34.4,"AUGUST",30,1,"medium_poverty",31
"1320","2011","West Bank and Gaza","Gini index",34.4,"JULY",4,0,"medium_poverty",4
"1321","2011","West Bank and Gaza","Income share held by third 20%",15.9,"MARCH",15,5,"medium_poverty",20
"1322","2011","West Bank and Gaza","Income share held by third 20%",15.9,"FEBRUARY",6,0,"medium_poverty",6
"1323","2011","West Bank and Gaza","Income share held by third 20%",15.9,"JANUARY",10,0,"medium_poverty",10
"1324","2011","West Bank and Gaza","Income share held by third 20%",15.9,"APRIL",24,2,"medium_poverty",26
"1325","2011","West Bank and Gaza","Income share held by third 20%",15.9,"SEPTEMBER",2,2,"medium_poverty",4
"1326","2011","West Bank and Gaza","Income share held by third 20%",15.9,"DECEMBER",8,0,"medium_poverty",8
"1327","2011","West Bank and Gaza","Income share held by third 20%",15.9,"NOVEMBER",4,0,"medium_poverty",4
"1328","2011","West Bank and Gaza","Income share held by third 20%",15.9,"OCTOBER",12,0,"medium_poverty",12
"1329","2011","West Bank and Gaza","Income share held by third 20%",15.9,"MAY",2,0,"medium_poverty",2
"1330","2011","West Bank and Gaza","Income share held by third 20%",15.9,"JUNE",0,0,"medium_poverty",0
"1331","2011","West Bank and Gaza","Income share held by third 20%",15.9,"AUGUST",30,1,"medium_poverty",31
"1332","2011","West Bank and Gaza","Income share held by third 20%",15.9,"JULY",4,0,"medium_poverty",4
"1333","2011","West Bank and Gaza","Income share held by second 20%",11.9,"MARCH",15,5,"medium_poverty",20
"1334","2011","West Bank and Gaza","Income share held by second 20%",11.9,"FEBRUARY",6,0,"medium_poverty",6
"1335","2011","West Bank and Gaza","Income share held by second 20%",11.9,"JANUARY",10,0,"medium_poverty",10
"1336","2011","West Bank and Gaza","Income share held by second 20%",11.9,"APRIL",24,2,"medium_poverty",26
"1337","2011","West Bank and Gaza","Income share held by second 20%",11.9,"SEPTEMBER",2,2,"medium_poverty",4
"1338","2011","West Bank and Gaza","Income share held by second 20%",11.9,"DECEMBER",8,0,"medium_poverty",8
"1339","2011","West Bank and Gaza","Income share held by second 20%",11.9,"NOVEMBER",4,0,"medium_poverty",4
"1340","2011","West Bank and Gaza","Income share held by second 20%",11.9,"OCTOBER",12,0,"medium_poverty",12
"1341","2011","West Bank and Gaza","Income share held by second 20%",11.9,"MAY",2,0,"medium_poverty",2
"1342","2011","West Bank and Gaza","Income share held by second 20%",11.9,"JUNE",0,0,"medium_poverty",0
"1343","2011","West Bank and Gaza","Income share held by second 20%",11.9,"AUGUST",30,1,"medium_poverty",31
"1344","2011","West Bank and Gaza","Income share held by second 20%",11.9,"JULY",4,0,"medium_poverty",4
"1345","2011","West Bank and Gaza","Income share held by fourth 20%",22,"MARCH",15,5,"medium_poverty",20
"1346","2011","West Bank and Gaza","Income share held by fourth 20%",22,"FEBRUARY",6,0,"medium_poverty",6
"1347","2011","West Bank and Gaza","Income share held by fourth 20%",22,"JANUARY",10,0,"medium_poverty",10
"1348","2011","West Bank and Gaza","Income share held by fourth 20%",22,"APRIL",24,2,"medium_poverty",26
"1349","2011","West Bank and Gaza","Income share held by fourth 20%",22,"SEPTEMBER",2,2,"medium_poverty",4
"1350","2011","West Bank and Gaza","Income share held by fourth 20%",22,"DECEMBER",8,0,"medium_poverty",8
"1351","2011","West Bank and Gaza","Income share held by fourth 20%",22,"NOVEMBER",4,0,"medium_poverty",4
"1352","2011","West Bank and Gaza","Income share held by fourth 20%",22,"OCTOBER",12,0,"medium_poverty",12
"1353","2011","West Bank and Gaza","Income share held by fourth 20%",22,"MAY",2,0,"medium_poverty",2
"1354","2011","West Bank and Gaza","Income share held by fourth 20%",22,"JUNE",0,0,"medium_poverty",0
"1355","2011","West Bank and Gaza","Income share held by fourth 20%",22,"AUGUST",30,1,"medium_poverty",31
"1356","2011","West Bank and Gaza","Income share held by fourth 20%",22,"JULY",4,0,"medium_poverty",4
"1357","2011","West Bank and Gaza","Poverty headcount ratio at $3.65 a day (2017 PPP) (% of population)",1.8,"MARCH",15,5,"high_poverty",20
"1358","2011","West Bank and Gaza","Poverty headcount ratio at $3.65 a day (2017 PPP) (% of population)",1.8,"FEBRUARY",6,0,"high_poverty",6
"1359","2011","West Bank and Gaza","Poverty headcount ratio at $3.65 a day (2017 PPP) (% of population)",1.8,"JANUARY",10,0,"high_poverty",10
"1360","2011","West Bank and Gaza","Poverty headcount ratio at $3.65 a day (2017 PPP) (% of population)",1.8,"APRIL",24,2,"high_poverty",26
"1361","2011","West Bank and Gaza","Poverty headcount ratio at $3.65 a day (2017 PPP) (% of population)",1.8,"SEPTEMBER",2,2,"high_poverty",4
"1362","2011","West Bank and Gaza","Poverty headcount ratio at $3.65 a day (2017 PPP) (% of population)",1.8,"DECEMBER",8,0,"high_poverty",8
"1363","2011","West Bank and Gaza","Poverty headcount ratio at $3.65 a day (2017 PPP) (% of population)",1.8,"NOVEMBER",4,0,"high_poverty",4
"1364","2011","West Bank and Gaza","Poverty headcount ratio at $3.65 a day (2017 PPP) (% of population)",1.8,"OCTOBER",12,0,"high_poverty",12
"1365","2011","West Bank and Gaza","Poverty headcount ratio at $3.65 a day (2017 PPP) (% of population)",1.8,"MAY",2,0,"high_poverty",2
"1366","2011","West Bank and Gaza","Poverty headcount ratio at $3.65 a day (2017 PPP) (% of population)",1.8,"JUNE",0,0,"high_poverty",0
"1367","2011","West Bank and Gaza","Poverty headcount ratio at $3.65 a day (2017 PPP) (% of population)",1.8,"AUGUST",30,1,"high_poverty",31
"1368","2011","West Bank and Gaza","Poverty headcount ratio at $3.65 a day (2017 PPP) (% of population)",1.8,"JULY",4,0,"high_poverty",4
"1369","2012","West Bank and Gaza","Population living in slums (% of urban population)",23.35102,"MARCH",28,0,"medium_poverty",28
"1370","2012","West Bank and Gaza","Population living in slums (% of urban population)",23.35102,"FEBRUARY",2,0,"medium_poverty",2
"1371","2012","West Bank and Gaza","Population living in slums (% of urban population)",23.35102,"JANUARY",2,0,"medium_poverty",2
"1372","2012","West Bank and Gaza","Population living in slums (% of urban population)",23.35102,"SEPTEMBER",8,0,"medium_poverty",8
"1373","2012","West Bank and Gaza","Population living in slums (% of urban population)",23.35102,"DECEMBER",2,0,"medium_poverty",2
"1374","2012","West Bank and Gaza","Population living in slums (% of urban population)",23.35102,"NOVEMBER",181,6,"medium_poverty",187
"1375","2012","West Bank and Gaza","Population living in slums (% of urban population)",23.35102,"OCTOBER",12,0,"medium_poverty",12
"1376","2012","West Bank and Gaza","Population living in slums (% of urban population)",23.35102,"MAY",0,0,"medium_poverty",0
"1377","2012","West Bank and Gaza","Population living in slums (% of urban population)",23.35102,"AUGUST",1,0,"medium_poverty",1
"1378","2012","West Bank and Gaza","Population living in slums (% of urban population)",23.35102,"JULY",3,0,"medium_poverty",3
"1379","2012","West Bank and Gaza","Population living in slums (% of urban population)",23.35102,"JUNE",15,1,"medium_poverty",16
"1380","2012","West Bank and Gaza","Population living in slums (% of urban population)",23.35102,"APRIL",1,0,"medium_poverty",1
"1381","2014","West Bank and Gaza","Population living in slums (% of urban population)",21.44433,"JANUARY",6,0,"medium_poverty",6
"1382","2014","West Bank and Gaza","Population living in slums (% of urban population)",21.44433,"DECEMBER",5,0,"medium_poverty",5
"1383","2014","West Bank and Gaza","Population living in slums (% of urban population)",21.44433,"NOVEMBER",8,10,"medium_poverty",18
"1384","2014","West Bank and Gaza","Population living in slums (% of urban population)",21.44433,"OCTOBER",8,2,"medium_poverty",10
"1385","2014","West Bank and Gaza","Population living in slums (% of urban population)",21.44433,"SEPTEMBER",20,0,"medium_poverty",20
"1386","2014","West Bank and Gaza","Population living in slums (% of urban population)",21.44433,"AUGUST",614,9,"medium_poverty",623
"1387","2014","West Bank and Gaza","Population living in slums (% of urban population)",21.44433,"JULY",1590,59,"medium_poverty",1649
"1388","2014","West Bank and Gaza","Population living in slums (% of urban population)",21.44433,"JUNE",10,3,"medium_poverty",13
"1389","2014","West Bank and Gaza","Population living in slums (% of urban population)",21.44433,"MAY",3,1,"medium_poverty",4
"1390","2014","West Bank and Gaza","Population living in slums (% of urban population)",21.44433,"APRIL",0,1,"medium_poverty",1
"1391","2014","West Bank and Gaza","Population living in slums (% of urban population)",21.44433,"MARCH",12,0,"medium_poverty",12
"1392","2014","West Bank and Gaza","Population living in slums (% of urban population)",21.44433,"FEBRUARY",3,0,"medium_poverty",3
"1393","2016","West Bank and Gaza","Population living in slums (% of urban population)",19.53763,"DECEMBER",5,0,"medium_poverty",5
"1394","2016","West Bank and Gaza","Population living in slums (% of urban population)",19.53763,"NOVEMBER",6,0,"medium_poverty",6
"1395","2016","West Bank and Gaza","Population living in slums (% of urban population)",19.53763,"AUGUST",3,0,"medium_poverty",3
"1396","2016","West Bank and Gaza","Population living in slums (% of urban population)",19.53763,"JULY",9,1,"medium_poverty",10
"1397","2016","West Bank and Gaza","Population living in slums (% of urban population)",19.53763,"JUNE",7,5,"medium_poverty",12
"1398","2016","West Bank and Gaza","Population living in slums (% of urban population)",19.53763,"MAY",3,0,"medium_poverty",3
"1399","2016","West Bank and Gaza","Population living in slums (% of urban population)",19.53763,"APRIL",3,0,"medium_poverty",3
"1400","2016","West Bank and Gaza","Population living in slums (% of urban population)",19.53763,"MARCH",23,0,"medium_poverty",23
"1401","2016","West Bank and Gaza","Population living in slums (% of urban population)",19.53763,"FEBRUARY",17,2,"medium_poverty",19
"1402","2016","West Bank and Gaza","Population living in slums (% of urban population)",19.53763,"JANUARY",20,2,"medium_poverty",22
"1403","2016","West Bank and Gaza","Population living in slums (% of urban population)",19.53763,"OCTOBER",8,2,"medium_poverty",10
"1404","2016","West Bank and Gaza","Population living in slums (% of urban population)",19.53763,"SEPTEMBER",11,0,"medium_poverty",11
"1405","2016","West Bank and Gaza","Income share held by highest 10%",25.2,"DECEMBER",5,0,"medium_poverty",5
"1406","2016","West Bank and Gaza","Income share held by highest 10%",25.2,"NOVEMBER",6,0,"medium_poverty",6
"1407","2016","West Bank and Gaza","Income share held by highest 10%",25.2,"AUGUST",3,0,"medium_poverty",3
"1408","2016","West Bank and Gaza","Income share held by highest 10%",25.2,"JULY",9,1,"medium_poverty",10
"1409","2016","West Bank and Gaza","Income share held by highest 10%",25.2,"JUNE",7,5,"medium_poverty",12
"1410","2016","West Bank and Gaza","Income share held by highest 10%",25.2,"MAY",3,0,"medium_poverty",3
"1411","2016","West Bank and Gaza","Income share held by highest 10%",25.2,"APRIL",3,0,"medium_poverty",3
"1412","2016","West Bank and Gaza","Income share held by highest 10%",25.2,"MARCH",23,0,"medium_poverty",23
"1413","2016","West Bank and Gaza","Income share held by highest 10%",25.2,"FEBRUARY",17,2,"medium_poverty",19
"1414","2016","West Bank and Gaza","Income share held by highest 10%",25.2,"JANUARY",20,2,"medium_poverty",22
"1415","2016","West Bank and Gaza","Income share held by highest 10%",25.2,"OCTOBER",8,2,"medium_poverty",10
"1416","2016","West Bank and Gaza","Income share held by highest 10%",25.2,"SEPTEMBER",11,0,"medium_poverty",11
"1417","2016","West Bank and Gaza","Survey mean consumption or income per capita, bottom 40% of population (2017 PPP $ per day)",6.63,"DECEMBER",5,0,"high_poverty",5
"1418","2016","West Bank and Gaza","Survey mean consumption or income per capita, bottom 40% of population (2017 PPP $ per day)",6.63,"NOVEMBER",6,0,"high_poverty",6
"1419","2016","West Bank and Gaza","Survey mean consumption or income per capita, bottom 40% of population (2017 PPP $ per day)",6.63,"AUGUST",3,0,"high_poverty",3
"1420","2016","West Bank and Gaza","Survey mean consumption or income per capita, bottom 40% of population (2017 PPP $ per day)",6.63,"JULY",9,1,"high_poverty",10
"1421","2016","West Bank and Gaza","Survey mean consumption or income per capita, bottom 40% of population (2017 PPP $ per day)",6.63,"JUNE",7,5,"high_poverty",12
"1422","2016","West Bank and Gaza","Survey mean consumption or income per capita, bottom 40% of population (2017 PPP $ per day)",6.63,"MAY",3,0,"high_poverty",3
"1423","2016","West Bank and Gaza","Survey mean consumption or income per capita, bottom 40% of population (2017 PPP $ per day)",6.63,"APRIL",3,0,"high_poverty",3
"1424","2016","West Bank and Gaza","Survey mean consumption or income per capita, bottom 40% of population (2017 PPP $ per day)",6.63,"MARCH",23,0,"high_poverty",23
"1425","2016","West Bank and Gaza","Survey mean consumption or income per capita, bottom 40% of population (2017 PPP $ per day)",6.63,"FEBRUARY",17,2,"high_poverty",19
"1426","2016","West Bank and Gaza","Survey mean consumption or income per capita, bottom 40% of population (2017 PPP $ per day)",6.63,"JANUARY",20,2,"high_poverty",22
"1427","2016","West Bank and Gaza","Survey mean consumption or income per capita, bottom 40% of population (2017 PPP $ per day)",6.63,"OCTOBER",8,2,"high_poverty",10
"1428","2016","West Bank and Gaza","Survey mean consumption or income per capita, bottom 40% of population (2017 PPP $ per day)",6.63,"SEPTEMBER",11,0,"high_poverty",11
"1429","2016","West Bank and Gaza","Income share held by third 20%",16.6,"DECEMBER",5,0,"medium_poverty",5
"1430","2016","West Bank and Gaza","Income share held by third 20%",16.6,"NOVEMBER",6,0,"medium_poverty",6
"1431","2016","West Bank and Gaza","Income share held by third 20%",16.6,"AUGUST",3,0,"medium_poverty",3
"1432","2016","West Bank and Gaza","Income share held by third 20%",16.6,"JULY",9,1,"medium_poverty",10
"1433","2016","West Bank and Gaza","Income share held by third 20%",16.6,"JUNE",7,5,"medium_poverty",12
"1434","2016","West Bank and Gaza","Income share held by third 20%",16.6,"MAY",3,0,"medium_poverty",3
"1435","2016","West Bank and Gaza","Income share held by third 20%",16.6,"APRIL",3,0,"medium_poverty",3
"1436","2016","West Bank and Gaza","Income share held by third 20%",16.6,"MARCH",23,0,"medium_poverty",23
"1437","2016","West Bank and Gaza","Income share held by third 20%",16.6,"FEBRUARY",17,2,"medium_poverty",19
"1438","2016","West Bank and Gaza","Income share held by third 20%",16.6,"JANUARY",20,2,"medium_poverty",22
"1439","2016","West Bank and Gaza","Income share held by third 20%",16.6,"OCTOBER",8,2,"medium_poverty",10
"1440","2016","West Bank and Gaza","Income share held by third 20%",16.6,"SEPTEMBER",11,0,"medium_poverty",11
"1441","2016","West Bank and Gaza","Annualized average growth rate in per capita real survey mean consumption or income, bottom 40% of population (%)",-0.89,"DECEMBER",5,0,"high_poverty",5
"1442","2016","West Bank and Gaza","Annualized average growth rate in per capita real survey mean consumption or income, bottom 40% of population (%)",-0.89,"NOVEMBER",6,0,"high_poverty",6
"1443","2016","West Bank and Gaza","Annualized average growth rate in per capita real survey mean consumption or income, bottom 40% of population (%)",-0.89,"AUGUST",3,0,"high_poverty",3
"1444","2016","West Bank and Gaza","Annualized average growth rate in per capita real survey mean consumption or income, bottom 40% of population (%)",-0.89,"JULY",9,1,"high_poverty",10
"1445","2016","West Bank and Gaza","Annualized average growth rate in per capita real survey mean consumption or income, bottom 40% of population (%)",-0.89,"JUNE",7,5,"high_poverty",12
"1446","2016","West Bank and Gaza","Annualized average growth rate in per capita real survey mean consumption or income, bottom 40% of population (%)",-0.89,"MAY",3,0,"high_poverty",3
"1447","2016","West Bank and Gaza","Annualized average growth rate in per capita real survey mean consumption or income, bottom 40% of population (%)",-0.89,"APRIL",3,0,"high_poverty",3
"1448","2016","West Bank and Gaza","Annualized average growth rate in per capita real survey mean consumption or income, bottom 40% of population (%)",-0.89,"MARCH",23,0,"high_poverty",23
"1449","2016","West Bank and Gaza","Annualized average growth rate in per capita real survey mean consumption or income, bottom 40% of population (%)",-0.89,"FEBRUARY",17,2,"high_poverty",19
"1450","2016","West Bank and Gaza","Annualized average growth rate in per capita real survey mean consumption or income, bottom 40% of population (%)",-0.89,"JANUARY",20,2,"high_poverty",22
"1451","2016","West Bank and Gaza","Annualized average growth rate in per capita real survey mean consumption or income, bottom 40% of population (%)",-0.89,"OCTOBER",8,2,"high_poverty",10
"1452","2016","West Bank and Gaza","Annualized average growth rate in per capita real survey mean consumption or income, bottom 40% of population (%)",-0.89,"SEPTEMBER",11,0,"high_poverty",11
"1453","2016","West Bank and Gaza","Survey mean consumption or income per capita, total population (2017 PPP $ per day)",13.83,"DECEMBER",5,0,"low_poverty",5
"1454","2016","West Bank and Gaza","Survey mean consumption or income per capita, total population (2017 PPP $ per day)",13.83,"NOVEMBER",6,0,"low_poverty",6
"1455","2016","West Bank and Gaza","Survey mean consumption or income per capita, total population (2017 PPP $ per day)",13.83,"AUGUST",3,0,"low_poverty",3
"1456","2016","West Bank and Gaza","Survey mean consumption or income per capita, total population (2017 PPP $ per day)",13.83,"JULY",9,1,"low_poverty",10
"1457","2016","West Bank and Gaza","Survey mean consumption or income per capita, total population (2017 PPP $ per day)",13.83,"JUNE",7,5,"low_poverty",12
"1458","2016","West Bank and Gaza","Survey mean consumption or income per capita, total population (2017 PPP $ per day)",13.83,"MAY",3,0,"low_poverty",3
"1459","2016","West Bank and Gaza","Survey mean consumption or income per capita, total population (2017 PPP $ per day)",13.83,"APRIL",3,0,"low_poverty",3
"1460","2016","West Bank and Gaza","Survey mean consumption or income per capita, total population (2017 PPP $ per day)",13.83,"MARCH",23,0,"low_poverty",23
"1461","2016","West Bank and Gaza","Survey mean consumption or income per capita, total population (2017 PPP $ per day)",13.83,"FEBRUARY",17,2,"low_poverty",19
"1462","2016","West Bank and Gaza","Survey mean consumption or income per capita, total population (2017 PPP $ per day)",13.83,"JANUARY",20,2,"low_poverty",22
"1463","2016","West Bank and Gaza","Survey mean consumption or income per capita, total population (2017 PPP $ per day)",13.83,"OCTOBER",8,2,"low_poverty",10
"1464","2016","West Bank and Gaza","Survey mean consumption or income per capita, total population (2017 PPP $ per day)",13.83,"SEPTEMBER",11,0,"low_poverty",11
"1465","2016","West Bank and Gaza","Income share held by highest 20%",41.1,"DECEMBER",5,0,"medium_poverty",5
"1466","2016","West Bank and Gaza","Income share held by highest 20%",41.1,"NOVEMBER",6,0,"medium_poverty",6
"1467","2016","West Bank and Gaza","Income share held by highest 20%",41.1,"AUGUST",3,0,"medium_poverty",3
"1468","2016","West Bank and Gaza","Income share held by highest 20%",41.1,"JULY",9,1,"medium_poverty",10
"1469","2016","West Bank and Gaza","Income share held by highest 20%",41.1,"JUNE",7,5,"medium_poverty",12
"1470","2016","West Bank and Gaza","Income share held by highest 20%",41.1,"MAY",3,0,"medium_poverty",3
"1471","2016","West Bank and Gaza","Income share held by highest 20%",41.1,"APRIL",3,0,"medium_poverty",3
"1472","2016","West Bank and Gaza","Income share held by highest 20%",41.1,"MARCH",23,0,"medium_poverty",23
"1473","2016","West Bank and Gaza","Income share held by highest 20%",41.1,"FEBRUARY",17,2,"medium_poverty",19
"1474","2016","West Bank and Gaza","Income share held by highest 20%",41.1,"JANUARY",20,2,"medium_poverty",22
"1475","2016","West Bank and Gaza","Income share held by highest 20%",41.1,"OCTOBER",8,2,"medium_poverty",10
"1476","2016","West Bank and Gaza","Income share held by highest 20%",41.1,"SEPTEMBER",11,0,"medium_poverty",11
"1477","2016","West Bank and Gaza","Poverty gap at $6.85 a day (2017 PPP) (%)",5.3,"DECEMBER",5,0,"high_poverty",5
"1478","2016","West Bank and Gaza","Poverty gap at $6.85 a day (2017 PPP) (%)",5.3,"NOVEMBER",6,0,"high_poverty",6
"1479","2016","West Bank and Gaza","Poverty gap at $6.85 a day (2017 PPP) (%)",5.3,"AUGUST",3,0,"high_poverty",3
"1480","2016","West Bank and Gaza","Poverty gap at $6.85 a day (2017 PPP) (%)",5.3,"JULY",9,1,"high_poverty",10
"1481","2016","West Bank and Gaza","Poverty gap at $6.85 a day (2017 PPP) (%)",5.3,"JUNE",7,5,"high_poverty",12
"1482","2016","West Bank and Gaza","Poverty gap at $6.85 a day (2017 PPP) (%)",5.3,"MAY",3,0,"high_poverty",3
"1483","2016","West Bank and Gaza","Poverty gap at $6.85 a day (2017 PPP) (%)",5.3,"APRIL",3,0,"high_poverty",3
"1484","2016","West Bank and Gaza","Poverty gap at $6.85 a day (2017 PPP) (%)",5.3,"MARCH",23,0,"high_poverty",23
"1485","2016","West Bank and Gaza","Poverty gap at $6.85 a day (2017 PPP) (%)",5.3,"FEBRUARY",17,2,"high_poverty",19
"1486","2016","West Bank and Gaza","Poverty gap at $6.85 a day (2017 PPP) (%)",5.3,"JANUARY",20,2,"high_poverty",22
"1487","2016","West Bank and Gaza","Poverty gap at $6.85 a day (2017 PPP) (%)",5.3,"OCTOBER",8,2,"high_poverty",10
"1488","2016","West Bank and Gaza","Poverty gap at $6.85 a day (2017 PPP) (%)",5.3,"SEPTEMBER",11,0,"high_poverty",11
"1489","2016","West Bank and Gaza","Income share held by second 20%",11.9,"DECEMBER",5,0,"medium_poverty",5
"1490","2016","West Bank and Gaza","Income share held by second 20%",11.9,"NOVEMBER",6,0,"medium_poverty",6
"1491","2016","West Bank and Gaza","Income share held by second 20%",11.9,"AUGUST",3,0,"medium_poverty",3
"1492","2016","West Bank and Gaza","Income share held by second 20%",11.9,"JULY",9,1,"medium_poverty",10
"1493","2016","West Bank and Gaza","Income share held by second 20%",11.9,"JUNE",7,5,"medium_poverty",12
"1494","2016","West Bank and Gaza","Income share held by second 20%",11.9,"MAY",3,0,"medium_poverty",3
"1495","2016","West Bank and Gaza","Income share held by second 20%",11.9,"APRIL",3,0,"medium_poverty",3
"1496","2016","West Bank and Gaza","Income share held by second 20%",11.9,"MARCH",23,0,"medium_poverty",23
"1497","2016","West Bank and Gaza","Income share held by second 20%",11.9,"FEBRUARY",17,2,"medium_poverty",19
"1498","2016","West Bank and Gaza","Income share held by second 20%",11.9,"JANUARY",20,2,"medium_poverty",22
"1499","2016","West Bank and Gaza","Income share held by second 20%",11.9,"OCTOBER",8,2,"medium_poverty",10
"1500","2016","West Bank and Gaza","Income share held by second 20%",11.9,"SEPTEMBER",11,0,"medium_poverty",11
"1501","2016","West Bank and Gaza","Multidimensional poverty index (scale 0-1)",0.102,"DECEMBER",5,0,"medium_poverty",5
"1502","2016","West Bank and Gaza","Multidimensional poverty index (scale 0-1)",0.102,"NOVEMBER",6,0,"medium_poverty",6
"1503","2016","West Bank and Gaza","Multidimensional poverty index (scale 0-1)",0.102,"AUGUST",3,0,"medium_poverty",3
"1504","2016","West Bank and Gaza","Multidimensional poverty index (scale 0-1)",0.102,"JULY",9,1,"medium_poverty",10
"1505","2016","West Bank and Gaza","Multidimensional poverty index (scale 0-1)",0.102,"JUNE",7,5,"medium_poverty",12
"1506","2016","West Bank and Gaza","Multidimensional poverty index (scale 0-1)",0.102,"MAY",3,0,"medium_poverty",3
"1507","2016","West Bank and Gaza","Multidimensional poverty index (scale 0-1)",0.102,"APRIL",3,0,"medium_poverty",3
"1508","2016","West Bank and Gaza","Multidimensional poverty index (scale 0-1)",0.102,"MARCH",23,0,"medium_poverty",23
"1509","2016","West Bank and Gaza","Multidimensional poverty index (scale 0-1)",0.102,"FEBRUARY",17,2,"medium_poverty",19
"1510","2016","West Bank and Gaza","Multidimensional poverty index (scale 0-1)",0.102,"JANUARY",20,2,"medium_poverty",22
"1511","2016","West Bank and Gaza","Multidimensional poverty index (scale 0-1)",0.102,"OCTOBER",8,2,"medium_poverty",10
"1512","2016","West Bank and Gaza","Multidimensional poverty index (scale 0-1)",0.102,"SEPTEMBER",11,0,"medium_poverty",11
"1513","2016","West Bank and Gaza","Poverty headcount ratio at national poverty lines (% of population)",29.2,"DECEMBER",5,0,"medium_poverty",5
"1514","2016","West Bank and Gaza","Poverty headcount ratio at national poverty lines (% of population)",29.2,"NOVEMBER",6,0,"medium_poverty",6
"1515","2016","West Bank and Gaza","Poverty headcount ratio at national poverty lines (% of population)",29.2,"AUGUST",3,0,"medium_poverty",3
"1516","2016","West Bank and Gaza","Poverty headcount ratio at national poverty lines (% of population)",29.2,"JULY",9,1,"medium_poverty",10
"1517","2016","West Bank and Gaza","Poverty headcount ratio at national poverty lines (% of population)",29.2,"JUNE",7,5,"medium_poverty",12
"1518","2016","West Bank and Gaza","Poverty headcount ratio at national poverty lines (% of population)",29.2,"MAY",3,0,"medium_poverty",3
"1519","2016","West Bank and Gaza","Poverty headcount ratio at national poverty lines (% of population)",29.2,"APRIL",3,0,"medium_poverty",3
"1520","2016","West Bank and Gaza","Poverty headcount ratio at national poverty lines (% of population)",29.2,"MARCH",23,0,"medium_poverty",23
"1521","2016","West Bank and Gaza","Poverty headcount ratio at national poverty lines (% of population)",29.2,"FEBRUARY",17,2,"medium_poverty",19
"1522","2016","West Bank and Gaza","Poverty headcount ratio at national poverty lines (% of population)",29.2,"JANUARY",20,2,"medium_poverty",22
"1523","2016","West Bank and Gaza","Poverty headcount ratio at national poverty lines (% of population)",29.2,"OCTOBER",8,2,"medium_poverty",10
"1524","2016","West Bank and Gaza","Poverty headcount ratio at national poverty lines (% of population)",29.2,"SEPTEMBER",11,0,"medium_poverty",11
"1525","2016","West Bank and Gaza","Income share held by fourth 20%",23.2,"DECEMBER",5,0,"medium_poverty",5
"1526","2016","West Bank and Gaza","Income share held by fourth 20%",23.2,"NOVEMBER",6,0,"medium_poverty",6
"1527","2016","West Bank and Gaza","Income share held by fourth 20%",23.2,"AUGUST",3,0,"medium_poverty",3
"1528","2016","West Bank and Gaza","Income share held by fourth 20%",23.2,"JULY",9,1,"medium_poverty",10
"1529","2016","West Bank and Gaza","Income share held by fourth 20%",23.2,"JUNE",7,5,"medium_poverty",12
"1530","2016","West Bank and Gaza","Income share held by fourth 20%",23.2,"MAY",3,0,"medium_poverty",3
"1531","2016","West Bank and Gaza","Income share held by fourth 20%",23.2,"APRIL",3,0,"medium_poverty",3
"1532","2016","West Bank and Gaza","Income share held by fourth 20%",23.2,"MARCH",23,0,"medium_poverty",23
"1533","2016","West Bank and Gaza","Income share held by fourth 20%",23.2,"FEBRUARY",17,2,"medium_poverty",19
"1534","2016","West Bank and Gaza","Income share held by fourth 20%",23.2,"JANUARY",20,2,"medium_poverty",22
"1535","2016","West Bank and Gaza","Income share held by fourth 20%",23.2,"OCTOBER",8,2,"medium_poverty",10
"1536","2016","West Bank and Gaza","Income share held by fourth 20%",23.2,"SEPTEMBER",11,0,"medium_poverty",11
"1537","2016","West Bank and Gaza","Income share held by lowest 20%",7.3,"DECEMBER",5,0,"high_poverty",5
"1538","2016","West Bank and Gaza","Income share held by lowest 20%",7.3,"NOVEMBER",6,0,"high_poverty",6
"1539","2016","West Bank and Gaza","Income share held by lowest 20%",7.3,"AUGUST",3,0,"high_poverty",3
"1540","2016","West Bank and Gaza","Income share held by lowest 20%",7.3,"JULY",9,1,"high_poverty",10
"1541","2016","West Bank and Gaza","Income share held by lowest 20%",7.3,"JUNE",7,5,"high_poverty",12
"1542","2016","West Bank and Gaza","Income share held by lowest 20%",7.3,"MAY",3,0,"high_poverty",3
"1543","2016","West Bank and Gaza","Income share held by lowest 20%",7.3,"APRIL",3,0,"high_poverty",3
"1544","2016","West Bank and Gaza","Income share held by lowest 20%",7.3,"MARCH",23,0,"high_poverty",23
"1545","2016","West Bank and Gaza","Income share held by lowest 20%",7.3,"FEBRUARY",17,2,"high_poverty",19
"1546","2016","West Bank and Gaza","Income share held by lowest 20%",7.3,"JANUARY",20,2,"high_poverty",22
"1547","2016","West Bank and Gaza","Income share held by lowest 20%",7.3,"OCTOBER",8,2,"high_poverty",10
"1548","2016","West Bank and Gaza","Income share held by lowest 20%",7.3,"SEPTEMBER",11,0,"high_poverty",11
"1549","2016","West Bank and Gaza","Poverty headcount ratio at $6.85 a day (2017 PPP) (% of population)",20.5,"DECEMBER",5,0,"high_poverty",5
"1550","2016","West Bank and Gaza","Poverty headcount ratio at $6.85 a day (2017 PPP) (% of population)",20.5,"NOVEMBER",6,0,"high_poverty",6
"1551","2016","West Bank and Gaza","Poverty headcount ratio at $6.85 a day (2017 PPP) (% of population)",20.5,"AUGUST",3,0,"high_poverty",3
"1552","2016","West Bank and Gaza","Poverty headcount ratio at $6.85 a day (2017 PPP) (% of population)",20.5,"JULY",9,1,"high_poverty",10
"1553","2016","West Bank and Gaza","Poverty headcount ratio at $6.85 a day (2017 PPP) (% of population)",20.5,"JUNE",7,5,"high_poverty",12
"1554","2016","West Bank and Gaza","Poverty headcount ratio at $6.85 a day (2017 PPP) (% of population)",20.5,"MAY",3,0,"high_poverty",3
"1555","2016","West Bank and Gaza","Poverty headcount ratio at $6.85 a day (2017 PPP) (% of population)",20.5,"APRIL",3,0,"high_poverty",3
"1556","2016","West Bank and Gaza","Poverty headcount ratio at $6.85 a day (2017 PPP) (% of population)",20.5,"MARCH",23,0,"high_poverty",23
"1557","2016","West Bank and Gaza","Poverty headcount ratio at $6.85 a day (2017 PPP) (% of population)",20.5,"FEBRUARY",17,2,"high_poverty",19
"1558","2016","West Bank and Gaza","Poverty headcount ratio at $6.85 a day (2017 PPP) (% of population)",20.5,"JANUARY",20,2,"high_poverty",22
"1559","2016","West Bank and Gaza","Poverty headcount ratio at $6.85 a day (2017 PPP) (% of population)",20.5,"OCTOBER",8,2,"high_poverty",10
"1560","2016","West Bank and Gaza","Poverty headcount ratio at $6.85 a day (2017 PPP) (% of population)",20.5,"SEPTEMBER",11,0,"high_poverty",11
"1561","2016","West Bank and Gaza","Poverty headcount ratio at $3.65 a day (2017 PPP) (% of population)",3.1,"DECEMBER",5,0,"high_poverty",5
"1562","2016","West Bank and Gaza","Poverty headcount ratio at $3.65 a day (2017 PPP) (% of population)",3.1,"NOVEMBER",6,0,"high_poverty",6
"1563","2016","West Bank and Gaza","Poverty headcount ratio at $3.65 a day (2017 PPP) (% of population)",3.1,"AUGUST",3,0,"high_poverty",3
"1564","2016","West Bank and Gaza","Poverty headcount ratio at $3.65 a day (2017 PPP) (% of population)",3.1,"JULY",9,1,"high_poverty",10
"1565","2016","West Bank and Gaza","Poverty headcount ratio at $3.65 a day (2017 PPP) (% of population)",3.1,"JUNE",7,5,"high_poverty",12
"1566","2016","West Bank and Gaza","Poverty headcount ratio at $3.65 a day (2017 PPP) (% of population)",3.1,"MAY",3,0,"high_poverty",3
"1567","2016","West Bank and Gaza","Poverty headcount ratio at $3.65 a day (2017 PPP) (% of population)",3.1,"APRIL",3,0,"high_poverty",3
"1568","2016","West Bank and Gaza","Poverty headcount ratio at $3.65 a day (2017 PPP) (% of population)",3.1,"MARCH",23,0,"high_poverty",23
"1569","2016","West Bank and Gaza","Poverty headcount ratio at $3.65 a day (2017 PPP) (% of population)",3.1,"FEBRUARY",17,2,"high_poverty",19
"1570","2016","West Bank and Gaza","Poverty headcount ratio at $3.65 a day (2017 PPP) (% of population)",3.1,"JANUARY",20,2,"high_poverty",22
"1571","2016","West Bank and Gaza","Poverty headcount ratio at $3.65 a day (2017 PPP) (% of population)",3.1,"OCTOBER",8,2,"high_poverty",10
"1572","2016","West Bank and Gaza","Poverty headcount ratio at $3.65 a day (2017 PPP) (% of population)",3.1,"SEPTEMBER",11,0,"high_poverty",11
"1573","2016","West Bank and Gaza","Poverty gap at $2.15 a day (2017 PPP) (%)",0.1,"DECEMBER",5,0,"high_poverty",5
"1574","2016","West Bank and Gaza","Poverty gap at $2.15 a day (2017 PPP) (%)",0.1,"NOVEMBER",6,0,"high_poverty",6
"1575","2016","West Bank and Gaza","Poverty gap at $2.15 a day (2017 PPP) (%)",0.1,"AUGUST",3,0,"high_poverty",3
"1576","2016","West Bank and Gaza","Poverty gap at $2.15 a day (2017 PPP) (%)",0.1,"JULY",9,1,"high_poverty",10
"1577","2016","West Bank and Gaza","Poverty gap at $2.15 a day (2017 PPP) (%)",0.1,"JUNE",7,5,"high_poverty",12
"1578","2016","West Bank and Gaza","Poverty gap at $2.15 a day (2017 PPP) (%)",0.1,"MAY",3,0,"high_poverty",3
"1579","2016","West Bank and Gaza","Poverty gap at $2.15 a day (2017 PPP) (%)",0.1,"APRIL",3,0,"high_poverty",3
"1580","2016","West Bank and Gaza","Poverty gap at $2.15 a day (2017 PPP) (%)",0.1,"MARCH",23,0,"high_poverty",23
"1581","2016","West Bank and Gaza","Poverty gap at $2.15 a day (2017 PPP) (%)",0.1,"FEBRUARY",17,2,"high_poverty",19
"1582","2016","West Bank and Gaza","Poverty gap at $2.15 a day (2017 PPP) (%)",0.1,"JANUARY",20,2,"high_poverty",22
"1583","2016","West Bank and Gaza","Poverty gap at $2.15 a day (2017 PPP) (%)",0.1,"OCTOBER",8,2,"high_poverty",10
"1584","2016","West Bank and Gaza","Poverty gap at $2.15 a day (2017 PPP) (%)",0.1,"SEPTEMBER",11,0,"high_poverty",11
"1585","2016","West Bank and Gaza","Annualized average growth rate in per capita real survey mean consumption or income, total population (%)",-0.55,"DECEMBER",5,0,"low_poverty",5
"1586","2016","West Bank and Gaza","Annualized average growth rate in per capita real survey mean consumption or income, total population (%)",-0.55,"NOVEMBER",6,0,"low_poverty",6
"1587","2016","West Bank and Gaza","Annualized average growth rate in per capita real survey mean consumption or income, total population (%)",-0.55,"AUGUST",3,0,"low_poverty",3
"1588","2016","West Bank and Gaza","Annualized average growth rate in per capita real survey mean consumption or income, total population (%)",-0.55,"JULY",9,1,"low_poverty",10
"1589","2016","West Bank and Gaza","Annualized average growth rate in per capita real survey mean consumption or income, total population (%)",-0.55,"JUNE",7,5,"low_poverty",12
"1590","2016","West Bank and Gaza","Annualized average growth rate in per capita real survey mean consumption or income, total population (%)",-0.55,"MAY",3,0,"low_poverty",3
"1591","2016","West Bank and Gaza","Annualized average growth rate in per capita real survey mean consumption or income, total population (%)",-0.55,"APRIL",3,0,"low_poverty",3
"1592","2016","West Bank and Gaza","Annualized average growth rate in per capita real survey mean consumption or income, total population (%)",-0.55,"MARCH",23,0,"low_poverty",23
"1593","2016","West Bank and Gaza","Annualized average growth rate in per capita real survey mean consumption or income, total population (%)",-0.55,"FEBRUARY",17,2,"low_poverty",19
"1594","2016","West Bank and Gaza","Annualized average growth rate in per capita real survey mean consumption or income, total population (%)",-0.55,"JANUARY",20,2,"low_poverty",22
"1595","2016","West Bank and Gaza","Annualized average growth rate in per capita real survey mean consumption or income, total population (%)",-0.55,"OCTOBER",8,2,"low_poverty",10
"1596","2016","West Bank and Gaza","Annualized average growth rate in per capita real survey mean consumption or income, total population (%)",-0.55,"SEPTEMBER",11,0,"low_poverty",11
"1597","2016","West Bank and Gaza","Income share held by lowest 10%",2.9,"DECEMBER",5,0,"high_poverty",5
"1598","2016","West Bank and Gaza","Income share held by lowest 10%",2.9,"NOVEMBER",6,0,"high_poverty",6
"1599","2016","West Bank and Gaza","Income share held by lowest 10%",2.9,"AUGUST",3,0,"high_poverty",3
"1600","2016","West Bank and Gaza","Income share held by lowest 10%",2.9,"JULY",9,1,"high_poverty",10
"1601","2016","West Bank and Gaza","Income share held by lowest 10%",2.9,"JUNE",7,5,"high_poverty",12
"1602","2016","West Bank and Gaza","Income share held by lowest 10%",2.9,"MAY",3,0,"high_poverty",3
"1603","2016","West Bank and Gaza","Income share held by lowest 10%",2.9,"APRIL",3,0,"high_poverty",3
"1604","2016","West Bank and Gaza","Income share held by lowest 10%",2.9,"MARCH",23,0,"high_poverty",23
"1605","2016","West Bank and Gaza","Income share held by lowest 10%",2.9,"FEBRUARY",17,2,"high_poverty",19
"1606","2016","West Bank and Gaza","Income share held by lowest 10%",2.9,"JANUARY",20,2,"high_poverty",22
"1607","2016","West Bank and Gaza","Income share held by lowest 10%",2.9,"OCTOBER",8,2,"high_poverty",10
"1608","2016","West Bank and Gaza","Income share held by lowest 10%",2.9,"SEPTEMBER",11,0,"high_poverty",11
"1609","2016","West Bank and Gaza","Proportion of people living below 50 percent of median income (%)",12.8,"DECEMBER",5,0,"medium_poverty",5
"1610","2016","West Bank and Gaza","Proportion of people living below 50 percent of median income (%)",12.8,"NOVEMBER",6,0,"medium_poverty",6
"1611","2016","West Bank and Gaza","Proportion of people living below 50 percent of median income (%)",12.8,"AUGUST",3,0,"medium_poverty",3
"1612","2016","West Bank and Gaza","Proportion of people living below 50 percent of median income (%)",12.8,"JULY",9,1,"medium_poverty",10
"1613","2016","West Bank and Gaza","Proportion of people living below 50 percent of median income (%)",12.8,"JUNE",7,5,"medium_poverty",12
"1614","2016","West Bank and Gaza","Proportion of people living below 50 percent of median income (%)",12.8,"MAY",3,0,"medium_poverty",3
"1615","2016","West Bank and Gaza","Proportion of people living below 50 percent of median income (%)",12.8,"APRIL",3,0,"medium_poverty",3
"1616","2016","West Bank and Gaza","Proportion of people living below 50 percent of median income (%)",12.8,"MARCH",23,0,"medium_poverty",23
"1617","2016","West Bank and Gaza","Proportion of people living below 50 percent of median income (%)",12.8,"FEBRUARY",17,2,"medium_poverty",19
"1618","2016","West Bank and Gaza","Proportion of people living below 50 percent of median income (%)",12.8,"JANUARY",20,2,"medium_poverty",22
"1619","2016","West Bank and Gaza","Proportion of people living below 50 percent of median income (%)",12.8,"OCTOBER",8,2,"medium_poverty",10
"1620","2016","West Bank and Gaza","Proportion of people living below 50 percent of median income (%)",12.8,"SEPTEMBER",11,0,"medium_poverty",11
"1621","2016","West Bank and Gaza","Gini index",33.7,"DECEMBER",5,0,"medium_poverty",5
"1622","2016","West Bank and Gaza","Gini index",33.7,"NOVEMBER",6,0,"medium_poverty",6
"1623","2016","West Bank and Gaza","Gini index",33.7,"AUGUST",3,0,"medium_poverty",3
"1624","2016","West Bank and Gaza","Gini index",33.7,"JULY",9,1,"medium_poverty",10
"1625","2016","West Bank and Gaza","Gini index",33.7,"JUNE",7,5,"medium_poverty",12
"1626","2016","West Bank and Gaza","Gini index",33.7,"MAY",3,0,"medium_poverty",3
"1627","2016","West Bank and Gaza","Gini index",33.7,"APRIL",3,0,"medium_poverty",3
"1628","2016","West Bank and Gaza","Gini index",33.7,"MARCH",23,0,"medium_poverty",23
"1629","2016","West Bank and Gaza","Gini index",33.7,"FEBRUARY",17,2,"medium_poverty",19
"1630","2016","West Bank and Gaza","Gini index",33.7,"JANUARY",20,2,"medium_poverty",22
"1631","2016","West Bank and Gaza","Gini index",33.7,"OCTOBER",8,2,"medium_poverty",10
"1632","2016","West Bank and Gaza","Gini index",33.7,"SEPTEMBER",11,0,"medium_poverty",11
"1633","2016","West Bank and Gaza","Multidimensional poverty intensity (average share of deprivations experienced by the poor)",42.4,"DECEMBER",5,0,"medium_poverty",5
"1634","2016","West Bank and Gaza","Multidimensional poverty intensity (average share of deprivations experienced by the poor)",42.4,"NOVEMBER",6,0,"medium_poverty",6
"1635","2016","West Bank and Gaza","Multidimensional poverty intensity (average share of deprivations experienced by the poor)",42.4,"AUGUST",3,0,"medium_poverty",3
"1636","2016","West Bank and Gaza","Multidimensional poverty intensity (average share of deprivations experienced by the poor)",42.4,"JULY",9,1,"medium_poverty",10
"1637","2016","West Bank and Gaza","Multidimensional poverty intensity (average share of deprivations experienced by the poor)",42.4,"JUNE",7,5,"medium_poverty",12
"1638","2016","West Bank and Gaza","Multidimensional poverty intensity (average share of deprivations experienced by the poor)",42.4,"MAY",3,0,"medium_poverty",3
"1639","2016","West Bank and Gaza","Multidimensional poverty intensity (average share of deprivations experienced by the poor)",42.4,"APRIL",3,0,"medium_poverty",3
"1640","2016","West Bank and Gaza","Multidimensional poverty intensity (average share of deprivations experienced by the poor)",42.4,"MARCH",23,0,"medium_poverty",23
"1641","2016","West Bank and Gaza","Multidimensional poverty intensity (average share of deprivations experienced by the poor)",42.4,"FEBRUARY",17,2,"medium_poverty",19
"1642","2016","West Bank and Gaza","Multidimensional poverty intensity (average share of deprivations experienced by the poor)",42.4,"JANUARY",20,2,"medium_poverty",22
"1643","2016","West Bank and Gaza","Multidimensional poverty intensity (average share of deprivations experienced by the poor)",42.4,"OCTOBER",8,2,"medium_poverty",10
"1644","2016","West Bank and Gaza","Multidimensional poverty intensity (average share of deprivations experienced by the poor)",42.4,"SEPTEMBER",11,0,"medium_poverty",11
"1645","2016","West Bank and Gaza","Poverty gap at $3.65 a day (2017 PPP) (%)",0.7,"DECEMBER",5,0,"high_poverty",5
"1646","2016","West Bank and Gaza","Poverty gap at $3.65 a day (2017 PPP) (%)",0.7,"NOVEMBER",6,0,"high_poverty",6
"1647","2016","West Bank and Gaza","Poverty gap at $3.65 a day (2017 PPP) (%)",0.7,"AUGUST",3,0,"high_poverty",3
"1648","2016","West Bank and Gaza","Poverty gap at $3.65 a day (2017 PPP) (%)",0.7,"JULY",9,1,"high_poverty",10
"1649","2016","West Bank and Gaza","Poverty gap at $3.65 a day (2017 PPP) (%)",0.7,"JUNE",7,5,"high_poverty",12
"1650","2016","West Bank and Gaza","Poverty gap at $3.65 a day (2017 PPP) (%)",0.7,"MAY",3,0,"high_poverty",3
"1651","2016","West Bank and Gaza","Poverty gap at $3.65 a day (2017 PPP) (%)",0.7,"APRIL",3,0,"high_poverty",3
"1652","2016","West Bank and Gaza","Poverty gap at $3.65 a day (2017 PPP) (%)",0.7,"MARCH",23,0,"high_poverty",23
"1653","2016","West Bank and Gaza","Poverty gap at $3.65 a day (2017 PPP) (%)",0.7,"FEBRUARY",17,2,"high_poverty",19
"1654","2016","West Bank and Gaza","Poverty gap at $3.65 a day (2017 PPP) (%)",0.7,"JANUARY",20,2,"high_poverty",22
"1655","2016","West Bank and Gaza","Poverty gap at $3.65 a day (2017 PPP) (%)",0.7,"OCTOBER",8,2,"high_poverty",10
"1656","2016","West Bank and Gaza","Poverty gap at $3.65 a day (2017 PPP) (%)",0.7,"SEPTEMBER",11,0,"high_poverty",11
"1657","2016","West Bank and Gaza","Multidimensional poverty headcount ratio, household (% of total households)",18.4,"DECEMBER",5,0,"medium_poverty",5
"1658","2016","West Bank and Gaza","Multidimensional poverty headcount ratio, household (% of total households)",18.4,"NOVEMBER",6,0,"medium_poverty",6
"1659","2016","West Bank and Gaza","Multidimensional poverty headcount ratio, household (% of total households)",18.4,"AUGUST",3,0,"medium_poverty",3
"1660","2016","West Bank and Gaza","Multidimensional poverty headcount ratio, household (% of total households)",18.4,"JULY",9,1,"medium_poverty",10
"1661","2016","West Bank and Gaza","Multidimensional poverty headcount ratio, household (% of total households)",18.4,"JUNE",7,5,"medium_poverty",12
"1662","2016","West Bank and Gaza","Multidimensional poverty headcount ratio, household (% of total households)",18.4,"MAY",3,0,"medium_poverty",3
"1663","2016","West Bank and Gaza","Multidimensional poverty headcount ratio, household (% of total households)",18.4,"APRIL",3,0,"medium_poverty",3
"1664","2016","West Bank and Gaza","Multidimensional poverty headcount ratio, household (% of total households)",18.4,"MARCH",23,0,"medium_poverty",23
"1665","2016","West Bank and Gaza","Multidimensional poverty headcount ratio, household (% of total households)",18.4,"FEBRUARY",17,2,"medium_poverty",19
"1666","2016","West Bank and Gaza","Multidimensional poverty headcount ratio, household (% of total households)",18.4,"JANUARY",20,2,"medium_poverty",22
"1667","2016","West Bank and Gaza","Multidimensional poverty headcount ratio, household (% of total households)",18.4,"OCTOBER",8,2,"medium_poverty",10
"1668","2016","West Bank and Gaza","Multidimensional poverty headcount ratio, household (% of total households)",18.4,"SEPTEMBER",11,0,"medium_poverty",11
"1669","2016","West Bank and Gaza","Multidimensional poverty headcount ratio (% of total population)",24,"DECEMBER",5,0,"medium_poverty",5
"1670","2016","West Bank and Gaza","Multidimensional poverty headcount ratio (% of total population)",24,"NOVEMBER",6,0,"medium_poverty",6
"1671","2016","West Bank and Gaza","Multidimensional poverty headcount ratio (% of total population)",24,"AUGUST",3,0,"medium_poverty",3
"1672","2016","West Bank and Gaza","Multidimensional poverty headcount ratio (% of total population)",24,"JULY",9,1,"medium_poverty",10
"1673","2016","West Bank and Gaza","Multidimensional poverty headcount ratio (% of total population)",24,"JUNE",7,5,"medium_poverty",12
"1674","2016","West Bank and Gaza","Multidimensional poverty headcount ratio (% of total population)",24,"MAY",3,0,"medium_poverty",3
"1675","2016","West Bank and Gaza","Multidimensional poverty headcount ratio (% of total population)",24,"APRIL",3,0,"medium_poverty",3
"1676","2016","West Bank and Gaza","Multidimensional poverty headcount ratio (% of total population)",24,"MARCH",23,0,"medium_poverty",23
"1677","2016","West Bank and Gaza","Multidimensional poverty headcount ratio (% of total population)",24,"FEBRUARY",17,2,"medium_poverty",19
"1678","2016","West Bank and Gaza","Multidimensional poverty headcount ratio (% of total population)",24,"JANUARY",20,2,"medium_poverty",22
"1679","2016","West Bank and Gaza","Multidimensional poverty headcount ratio (% of total population)",24,"OCTOBER",8,2,"medium_poverty",10
"1680","2016","West Bank and Gaza","Multidimensional poverty headcount ratio (% of total population)",24,"SEPTEMBER",11,0,"medium_poverty",11
"1681","2016","West Bank and Gaza","Poverty headcount ratio at $2.15 a day (2017 PPP) (% of population)",0.5,"DECEMBER",5,0,"high_poverty",5
"1682","2016","West Bank and Gaza","Poverty headcount ratio at $2.15 a day (2017 PPP) (% of population)",0.5,"NOVEMBER",6,0,"high_poverty",6
"1683","2016","West Bank and Gaza","Poverty headcount ratio at $2.15 a day (2017 PPP) (% of population)",0.5,"AUGUST",3,0,"high_poverty",3
"1684","2016","West Bank and Gaza","Poverty headcount ratio at $2.15 a day (2017 PPP) (% of population)",0.5,"JULY",9,1,"high_poverty",10
"1685","2016","West Bank and Gaza","Poverty headcount ratio at $2.15 a day (2017 PPP) (% of population)",0.5,"JUNE",7,5,"high_poverty",12
"1686","2016","West Bank and Gaza","Poverty headcount ratio at $2.15 a day (2017 PPP) (% of population)",0.5,"MAY",3,0,"high_poverty",3
"1687","2016","West Bank and Gaza","Poverty headcount ratio at $2.15 a day (2017 PPP) (% of population)",0.5,"APRIL",3,0,"high_poverty",3
"1688","2016","West Bank and Gaza","Poverty headcount ratio at $2.15 a day (2017 PPP) (% of population)",0.5,"MARCH",23,0,"high_poverty",23
"1689","2016","West Bank and Gaza","Poverty headcount ratio at $2.15 a day (2017 PPP) (% of population)",0.5,"FEBRUARY",17,2,"high_poverty",19
"1690","2016","West Bank and Gaza","Poverty headcount ratio at $2.15 a day (2017 PPP) (% of population)",0.5,"JANUARY",20,2,"high_poverty",22
"1691","2016","West Bank and Gaza","Poverty headcount ratio at $2.15 a day (2017 PPP) (% of population)",0.5,"OCTOBER",8,2,"high_poverty",10
"1692","2016","West Bank and Gaza","Poverty headcount ratio at $2.15 a day (2017 PPP) (% of population)",0.5,"SEPTEMBER",11,0,"high_poverty",11
"1693","2018","West Bank and Gaza","Population living in slums (% of urban population)",19.5,"SEPTEMBER",25,1,"medium_poverty",26
"1694","2018","West Bank and Gaza","Population living in slums (% of urban population)",19.5,"OCTOBER",32,2,"medium_poverty",34
"1695","2018","West Bank and Gaza","Population living in slums (% of urban population)",19.5,"FEBRUARY",9,1,"medium_poverty",10
"1696","2018","West Bank and Gaza","Population living in slums (% of urban population)",19.5,"JANUARY",7,1,"medium_poverty",8
"1697","2018","West Bank and Gaza","Population living in slums (% of urban population)",19.5,"APRIL",34,0,"medium_poverty",34
"1698","2018","West Bank and Gaza","Population living in slums (% of urban population)",19.5,"MARCH",20,3,"medium_poverty",23
"1699","2018","West Bank and Gaza","Population living in slums (% of urban population)",19.5,"DECEMBER",14,2,"medium_poverty",16
"1700","2018","West Bank and Gaza","Population living in slums (% of urban population)",19.5,"NOVEMBER",25,1,"medium_poverty",26
"1701","2018","West Bank and Gaza","Population living in slums (% of urban population)",19.5,"JUNE",18,0,"medium_poverty",18
"1702","2018","West Bank and Gaza","Population living in slums (% of urban population)",19.5,"MAY",66,1,"medium_poverty",67
"1703","2018","West Bank and Gaza","Population living in slums (% of urban population)",19.5,"AUGUST",16,0,"medium_poverty",16
"1704","2018","West Bank and Gaza","Population living in slums (% of urban population)",19.5,"JULY",24,2,"medium_poverty",26
"1705","2020","West Bank and Gaza","Population living in slums (% of urban population)",19.5,"MARCH",2,0,"medium_poverty",2
"1706","2020","West Bank and Gaza","Population living in slums (% of urban population)",19.5,"APRIL",1,0,"medium_poverty",1
"1707","2020","West Bank and Gaza","Population living in slums (% of urban population)",19.5,"SEPTEMBER",1,0,"medium_poverty",1
"1708","2020","West Bank and Gaza","Population living in slums (% of urban population)",19.5,"FEBRUARY",9,0,"medium_poverty",9
"1709","2020","West Bank and Gaza","Population living in slums (% of urban population)",19.5,"JANUARY",6,0,"medium_poverty",6
"1710","2020","West Bank and Gaza","Population living in slums (% of urban population)",19.5,"OCTOBER",2,0,"medium_poverty",2
"1711","2020","West Bank and Gaza","Population living in slums (% of urban population)",19.5,"JUNE",1,0,"medium_poverty",1
"1712","2020","West Bank and Gaza","Population living in slums (% of urban population)",19.5,"MAY",4,1,"medium_poverty",5
"1713","2020","West Bank and Gaza","Population living in slums (% of urban population)",19.5,"AUGUST",3,1,"medium_poverty",4
"1714","2020","West Bank and Gaza","Population living in slums (% of urban population)",19.5,"JULY",1,0,"medium_poverty",1
"1715","2020","West Bank and Gaza","Population living in slums (% of urban population)",19.5,"DECEMBER",2,1,"medium_poverty",3
"1716","2020","West Bank and Gaza","Population living in slums (% of urban population)",19.5,"NOVEMBER",2,0,"medium_poverty",2
