"Year","Country Name","Indicator Name","Value","Month","Palestinians Killed","Israelis Killed","Poverty_Level","Total_Killed"
"2002","West Bank and Gaza","Population living in slums (% of urban population)","30","AUGUST",53,13,"High Poverty",66
"2002","West Bank and Gaza","Population living in slums (% of urban population)","30","FEBRUARY",85,29,"High Poverty",114
"2002","West Bank and Gaza","Population living in slums (% of urban population)","30","JANUARY",28,16,"High Poverty",44
"2002","West Bank and Gaza","Population living in slums (% of urban population)","30","JUNE",57,57,"High Poverty",114
"2002","West Bank and Gaza","Population living in slums (% of urban population)","30","OCTOBER",66,22,"High Poverty",88
"2002","West Bank and Gaza","Population living in slums (% of urban population)","30","SEPTEMBER",51,13,"High Poverty",64
"2002","West Bank and Gaza","Population living in slums (% of urban population)","30","MARCH",237,122,"High Poverty",359
"2002","West Bank and Gaza","Population living in slums (% of urban population)","30","DECEMBER",72,7,"High Poverty",79
"2002","West Bank and Gaza","Population living in slums (% of urban population)","30","NOVEMBER",46,40,"High Poverty",86
"2002","West Bank and Gaza","Population living in slums (% of urban population)","30","MAY",48,29,"High Poverty",77
"2002","West Bank and Gaza","Population living in slums (% of urban population)","30","JULY",43,25,"High Poverty",68
"2002","West Bank and Gaza","Population living in slums (% of urban population)","30","APRIL",246,46,"High Poverty",292
"2004","West Bank and Gaza","Population living in slums (% of urban population)","30","JUNE",59,3,"High Poverty",62
"2004","West Bank and Gaza","Population living in slums (% of urban population)","30","DECEMBER",61,8,"High Poverty",69
"2004","West Bank and Gaza","Population living in slums (% of urban population)","30","AUGUST",39,17,"High Poverty",56
"2004","West Bank and Gaza","Population living in slums (% of urban population)","30","JULY",0,0,"High Poverty",0
"2004","West Bank and Gaza","Population living in slums (% of urban population)","30","APRIL",55,3,"High Poverty",58
"2004","West Bank and Gaza","Population living in slums (% of urban population)","30","MAY",113,19,"High Poverty",132
"2004","West Bank and Gaza","Population living in slums (% of urban population)","30","OCTOBER",145,3,"High Poverty",148
"2004","West Bank and Gaza","Population living in slums (% of urban population)","30","SEPTEMBER",112,11,"High Poverty",123
"2004","West Bank and Gaza","Population living in slums (% of urban population)","30","JANUARY",27,15,"High Poverty",42
"2004","West Bank and Gaza","Population living in slums (% of urban population)","30","FEBRUARY",54,11,"High Poverty",65
"2004","West Bank and Gaza","Population living in slums (% of urban population)","30","NOVEMBER",42,3,"High Poverty",45
"2004","West Bank and Gaza","Population living in slums (% of urban population)","30","MARCH",79,11,"High Poverty",90
"2004","West Bank and Gaza","Income share held by lowest 10%","3","JUNE",59,3,"High Poverty",62
"2004","West Bank and Gaza","Income share held by lowest 10%","3","DECEMBER",61,8,"High Poverty",69
"2004","West Bank and Gaza","Income share held by lowest 10%","3","AUGUST",39,17,"High Poverty",56
"2004","West Bank and Gaza","Income share held by lowest 10%","3","JULY",0,0,"High Poverty",0
"2004","West Bank and Gaza","Income share held by lowest 10%","3","APRIL",55,3,"High Poverty",58
"2004","West Bank and Gaza","Income share held by lowest 10%","3","MAY",113,19,"High Poverty",132
"2004","West Bank and Gaza","Income share held by lowest 10%","3","OCTOBER",145,3,"High Poverty",148
"2004","West Bank and Gaza","Income share held by lowest 10%","3","SEPTEMBER",112,11,"High Poverty",123
"2004","West Bank and Gaza","Income share held by lowest 10%","3","JANUARY",27,15,"High Poverty",42
"2004","West Bank and Gaza","Income share held by lowest 10%","3","FEBRUARY",54,11,"High Poverty",65
"2004","West Bank and Gaza","Income share held by lowest 10%","3","NOVEMBER",42,3,"High Poverty",45
"2004","West Bank and Gaza","Income share held by lowest 10%","3","MARCH",79,11,"High Poverty",90
"2004","West Bank and Gaza","Poverty gap at $6.85 a day (2017 PPP) (%)","6","JUNE",59,3,"High Poverty",62
"2004","West Bank and Gaza","Poverty gap at $6.85 a day (2017 PPP) (%)","6","DECEMBER",61,8,"High Poverty",69
"2004","West Bank and Gaza","Poverty gap at $6.85 a day (2017 PPP) (%)","6","AUGUST",39,17,"High Poverty",56
"2004","West Bank and Gaza","Poverty gap at $6.85 a day (2017 PPP) (%)","6","JULY",0,0,"High Poverty",0
"2004","West Bank and Gaza","Poverty gap at $6.85 a day (2017 PPP) (%)","6","APRIL",55,3,"High Poverty",58
"2004","West Bank and Gaza","Poverty gap at $6.85 a day (2017 PPP) (%)","6","MAY",113,19,"High Poverty",132
"2004","West Bank and Gaza","Poverty gap at $6.85 a day (2017 PPP) (%)","6","OCTOBER",145,3,"High Poverty",148
"2004","West Bank and Gaza","Poverty gap at $6.85 a day (2017 PPP) (%)","6","SEPTEMBER",112,11,"High Poverty",123
"2004","West Bank and Gaza","Poverty gap at $6.85 a day (2017 PPP) (%)","6","JANUARY",27,15,"High Poverty",42
"2004","West Bank and Gaza","Poverty gap at $6.85 a day (2017 PPP) (%)","6","FEBRUARY",54,11,"High Poverty",65
"2004","West Bank and Gaza","Poverty gap at $6.85 a day (2017 PPP) (%)","6","NOVEMBER",42,3,"High Poverty",45
"2004","West Bank and Gaza","Poverty gap at $6.85 a day (2017 PPP) (%)","6","MARCH",79,11,"High Poverty",90
"2004","West Bank and Gaza","Income share held by lowest 20%","7.5","JUNE",59,3,"High Poverty",62
"2004","West Bank and Gaza","Income share held by lowest 20%","7.5","DECEMBER",61,8,"High Poverty",69
"2004","West Bank and Gaza","Income share held by lowest 20%","7.5","AUGUST",39,17,"High Poverty",56
"2004","West Bank and Gaza","Income share held by lowest 20%","7.5","JULY",0,0,"High Poverty",0
"2004","West Bank and Gaza","Income share held by lowest 20%","7.5","APRIL",55,3,"High Poverty",58
"2004","West Bank and Gaza","Income share held by lowest 20%","7.5","MAY",113,19,"High Poverty",132
"2004","West Bank and Gaza","Income share held by lowest 20%","7.5","OCTOBER",145,3,"High Poverty",148
"2004","West Bank and Gaza","Income share held by lowest 20%","7.5","SEPTEMBER",112,11,"High Poverty",123
"2004","West Bank and Gaza","Income share held by lowest 20%","7.5","JANUARY",27,15,"High Poverty",42
"2004","West Bank and Gaza","Income share held by lowest 20%","7.5","FEBRUARY",54,11,"High Poverty",65
"2004","West Bank and Gaza","Income share held by lowest 20%","7.5","NOVEMBER",42,3,"High Poverty",45
"2004","West Bank and Gaza","Income share held by lowest 20%","7.5","MARCH",79,11,"High Poverty",90
"2004","West Bank and Gaza","Income share held by second 20%","12","JUNE",59,3,"Medium Poverty",62
"2004","West Bank and Gaza","Income share held by second 20%","12","DECEMBER",61,8,"Medium Poverty",69
"2004","West Bank and Gaza","Income share held by second 20%","12","AUGUST",39,17,"Medium Poverty",56
"2004","West Bank and Gaza","Income share held by second 20%","12","JULY",0,0,"Medium Poverty",0
"2004","West Bank and Gaza","Income share held by second 20%","12","APRIL",55,3,"Medium Poverty",58
"2004","West Bank and Gaza","Income share held by second 20%","12","MAY",113,19,"Medium Poverty",132
"2004","West Bank and Gaza","Income share held by second 20%","12","OCTOBER",145,3,"Medium Poverty",148
"2004","West Bank and Gaza","Income share held by second 20%","12","SEPTEMBER",112,11,"Medium Poverty",123
"2004","West Bank and Gaza","Income share held by second 20%","12","JANUARY",27,15,"Medium Poverty",42
"2004","West Bank and Gaza","Income share held by second 20%","12","FEBRUARY",54,11,"Medium Poverty",65
"2004","West Bank and Gaza","Income share held by second 20%","12","NOVEMBER",42,3,"Medium Poverty",45
"2004","West Bank and Gaza","Income share held by second 20%","12","MARCH",79,11,"Medium Poverty",90
"2004","West Bank and Gaza","Proportion of people living below 50 percent of median income (%)","10.4","JUNE",59,3,"Medium Poverty",62
"2004","West Bank and Gaza","Proportion of people living below 50 percent of median income (%)","10.4","DECEMBER",61,8,"Medium Poverty",69
"2004","West Bank and Gaza","Proportion of people living below 50 percent of median income (%)","10.4","AUGUST",39,17,"Medium Poverty",56
"2004","West Bank and Gaza","Proportion of people living below 50 percent of median income (%)","10.4","JULY",0,0,"Medium Poverty",0
"2004","West Bank and Gaza","Proportion of people living below 50 percent of median income (%)","10.4","APRIL",55,3,"Medium Poverty",58
"2004","West Bank and Gaza","Proportion of people living below 50 percent of median income (%)","10.4","MAY",113,19,"Medium Poverty",132
"2004","West Bank and Gaza","Proportion of people living below 50 percent of median income (%)","10.4","OCTOBER",145,3,"Medium Poverty",148
"2004","West Bank and Gaza","Proportion of people living below 50 percent of median income (%)","10.4","SEPTEMBER",112,11,"Medium Poverty",123
"2004","West Bank and Gaza","Proportion of people living below 50 percent of median income (%)","10.4","JANUARY",27,15,"Medium Poverty",42
"2004","West Bank and Gaza","Proportion of people living below 50 percent of median income (%)","10.4","FEBRUARY",54,11,"Medium Poverty",65
"2004","West Bank and Gaza","Proportion of people living below 50 percent of median income (%)","10.4","NOVEMBER",42,3,"Medium Poverty",45
"2004","West Bank and Gaza","Proportion of people living below 50 percent of median income (%)","10.4","MARCH",79,11,"Medium Poverty",90
"2004","West Bank and Gaza","Income share held by highest 20%","41.8","JUNE",59,3,"High Poverty",62
"2004","West Bank and Gaza","Income share held by highest 20%","41.8","DECEMBER",61,8,"High Poverty",69
"2004","West Bank and Gaza","Income share held by highest 20%","41.8","AUGUST",39,17,"High Poverty",56
"2004","West Bank and Gaza","Income share held by highest 20%","41.8","JULY",0,0,"High Poverty",0
"2004","West Bank and Gaza","Income share held by highest 20%","41.8","APRIL",55,3,"High Poverty",58
"2004","West Bank and Gaza","Income share held by highest 20%","41.8","MAY",113,19,"High Poverty",132
"2004","West Bank and Gaza","Income share held by highest 20%","41.8","OCTOBER",145,3,"High Poverty",148
"2004","West Bank and Gaza","Income share held by highest 20%","41.8","SEPTEMBER",112,11,"High Poverty",123
"2004","West Bank and Gaza","Income share held by highest 20%","41.8","JANUARY",27,15,"High Poverty",42
"2004","West Bank and Gaza","Income share held by highest 20%","41.8","FEBRUARY",54,11,"High Poverty",65
"2004","West Bank and Gaza","Income share held by highest 20%","41.8","NOVEMBER",42,3,"High Poverty",45
"2004","West Bank and Gaza","Income share held by highest 20%","41.8","MARCH",79,11,"High Poverty",90
"2004","West Bank and Gaza","Income share held by third 20%","16.3","JUNE",59,3,"Medium Poverty",62
"2004","West Bank and Gaza","Income share held by third 20%","16.3","DECEMBER",61,8,"Medium Poverty",69
"2004","West Bank and Gaza","Income share held by third 20%","16.3","AUGUST",39,17,"Medium Poverty",56
"2004","West Bank and Gaza","Income share held by third 20%","16.3","JULY",0,0,"Medium Poverty",0
"2004","West Bank and Gaza","Income share held by third 20%","16.3","APRIL",55,3,"Medium Poverty",58
"2004","West Bank and Gaza","Income share held by third 20%","16.3","MAY",113,19,"Medium Poverty",132
"2004","West Bank and Gaza","Income share held by third 20%","16.3","OCTOBER",145,3,"Medium Poverty",148
"2004","West Bank and Gaza","Income share held by third 20%","16.3","SEPTEMBER",112,11,"Medium Poverty",123
"2004","West Bank and Gaza","Income share held by third 20%","16.3","JANUARY",27,15,"Medium Poverty",42
"2004","West Bank and Gaza","Income share held by third 20%","16.3","FEBRUARY",54,11,"Medium Poverty",65
"2004","West Bank and Gaza","Income share held by third 20%","16.3","NOVEMBER",42,3,"Medium Poverty",45
"2004","West Bank and Gaza","Income share held by third 20%","16.3","MARCH",79,11,"Medium Poverty",90
"2004","West Bank and Gaza","Income share held by highest 10%","26.5","JUNE",59,3,"High Poverty",62
"2004","West Bank and Gaza","Income share held by highest 10%","26.5","DECEMBER",61,8,"High Poverty",69
"2004","West Bank and Gaza","Income share held by highest 10%","26.5","AUGUST",39,17,"High Poverty",56
"2004","West Bank and Gaza","Income share held by highest 10%","26.5","JULY",0,0,"High Poverty",0
"2004","West Bank and Gaza","Income share held by highest 10%","26.5","APRIL",55,3,"High Poverty",58
"2004","West Bank and Gaza","Income share held by highest 10%","26.5","MAY",113,19,"High Poverty",132
"2004","West Bank and Gaza","Income share held by highest 10%","26.5","OCTOBER",145,3,"High Poverty",148
"2004","West Bank and Gaza","Income share held by highest 10%","26.5","SEPTEMBER",112,11,"High Poverty",123
"2004","West Bank and Gaza","Income share held by highest 10%","26.5","JANUARY",27,15,"High Poverty",42
"2004","West Bank and Gaza","Income share held by highest 10%","26.5","FEBRUARY",54,11,"High Poverty",65
"2004","West Bank and Gaza","Income share held by highest 10%","26.5","NOVEMBER",42,3,"High Poverty",45
"2004","West Bank and Gaza","Income share held by highest 10%","26.5","MARCH",79,11,"High Poverty",90
"2004","West Bank and Gaza","Income share held by fourth 20%","22.4","JUNE",59,3,"High Poverty",62
"2004","West Bank and Gaza","Income share held by fourth 20%","22.4","DECEMBER",61,8,"High Poverty",69
"2004","West Bank and Gaza","Income share held by fourth 20%","22.4","AUGUST",39,17,"High Poverty",56
"2004","West Bank and Gaza","Income share held by fourth 20%","22.4","JULY",0,0,"High Poverty",0
"2004","West Bank and Gaza","Income share held by fourth 20%","22.4","APRIL",55,3,"High Poverty",58
"2004","West Bank and Gaza","Income share held by fourth 20%","22.4","MAY",113,19,"High Poverty",132
"2004","West Bank and Gaza","Income share held by fourth 20%","22.4","OCTOBER",145,3,"High Poverty",148
"2004","West Bank and Gaza","Income share held by fourth 20%","22.4","SEPTEMBER",112,11,"High Poverty",123
"2004","West Bank and Gaza","Income share held by fourth 20%","22.4","JANUARY",27,15,"High Poverty",42
"2004","West Bank and Gaza","Income share held by fourth 20%","22.4","FEBRUARY",54,11,"High Poverty",65
"2004","West Bank and Gaza","Income share held by fourth 20%","22.4","NOVEMBER",42,3,"High Poverty",45
"2004","West Bank and Gaza","Income share held by fourth 20%","22.4","MARCH",79,11,"High Poverty",90
"2004","West Bank and Gaza","Gini index","34","JUNE",59,3,"High Poverty",62
"2004","West Bank and Gaza","Gini index","34","DECEMBER",61,8,"High Poverty",69
"2004","West Bank and Gaza","Gini index","34","AUGUST",39,17,"High Poverty",56
"2004","West Bank and Gaza","Gini index","34","JULY",0,0,"High Poverty",0
"2004","West Bank and Gaza","Gini index","34","APRIL",55,3,"High Poverty",58
"2004","West Bank and Gaza","Gini index","34","MAY",113,19,"High Poverty",132
"2004","West Bank and Gaza","Gini index","34","OCTOBER",145,3,"High Poverty",148
"2004","West Bank and Gaza","Gini index","34","SEPTEMBER",112,11,"High Poverty",123
"2004","West Bank and Gaza","Gini index","34","JANUARY",27,15,"High Poverty",42
"2004","West Bank and Gaza","Gini index","34","FEBRUARY",54,11,"High Poverty",65
"2004","West Bank and Gaza","Gini index","34","NOVEMBER",42,3,"High Poverty",45
"2004","West Bank and Gaza","Gini index","34","MARCH",79,11,"High Poverty",90
"2004","West Bank and Gaza","Poverty headcount ratio at $2.15 a day (2017 PPP) (% of population)","0.6","JUNE",59,3,"Low Poverty",62
"2004","West Bank and Gaza","Poverty headcount ratio at $2.15 a day (2017 PPP) (% of population)","0.6","DECEMBER",61,8,"Low Poverty",69
"2004","West Bank and Gaza","Poverty headcount ratio at $2.15 a day (2017 PPP) (% of population)","0.6","AUGUST",39,17,"Low Poverty",56
"2004","West Bank and Gaza","Poverty headcount ratio at $2.15 a day (2017 PPP) (% of population)","0.6","JULY",0,0,"Low Poverty",0
"2004","West Bank and Gaza","Poverty headcount ratio at $2.15 a day (2017 PPP) (% of population)","0.6","APRIL",55,3,"Low Poverty",58
"2004","West Bank and Gaza","Poverty headcount ratio at $2.15 a day (2017 PPP) (% of population)","0.6","MAY",113,19,"Low Poverty",132
"2004","West Bank and Gaza","Poverty headcount ratio at $2.15 a day (2017 PPP) (% of population)","0.6","OCTOBER",145,3,"Low Poverty",148
"2004","West Bank and Gaza","Poverty headcount ratio at $2.15 a day (2017 PPP) (% of population)","0.6","SEPTEMBER",112,11,"Low Poverty",123
"2004","West Bank and Gaza","Poverty headcount ratio at $2.15 a day (2017 PPP) (% of population)","0.6","JANUARY",27,15,"Low Poverty",42
"2004","West Bank and Gaza","Poverty headcount ratio at $2.15 a day (2017 PPP) (% of population)","0.6","FEBRUARY",54,11,"Low Poverty",65
"2004","West Bank and Gaza","Poverty headcount ratio at $2.15 a day (2017 PPP) (% of population)","0.6","NOVEMBER",42,3,"Low Poverty",45
"2004","West Bank and Gaza","Poverty headcount ratio at $2.15 a day (2017 PPP) (% of population)","0.6","MARCH",79,11,"Low Poverty",90
"2004","West Bank and Gaza","Poverty headcount ratio at $3.65 a day (2017 PPP) (% of population)","3.6","JUNE",59,3,"High Poverty",62
"2004","West Bank and Gaza","Poverty headcount ratio at $3.65 a day (2017 PPP) (% of population)","3.6","DECEMBER",61,8,"High Poverty",69
"2004","West Bank and Gaza","Poverty headcount ratio at $3.65 a day (2017 PPP) (% of population)","3.6","AUGUST",39,17,"High Poverty",56
"2004","West Bank and Gaza","Poverty headcount ratio at $3.65 a day (2017 PPP) (% of population)","3.6","JULY",0,0,"High Poverty",0
"2004","West Bank and Gaza","Poverty headcount ratio at $3.65 a day (2017 PPP) (% of population)","3.6","APRIL",55,3,"High Poverty",58
"2004","West Bank and Gaza","Poverty headcount ratio at $3.65 a day (2017 PPP) (% of population)","3.6","MAY",113,19,"High Poverty",132
"2004","West Bank and Gaza","Poverty headcount ratio at $3.65 a day (2017 PPP) (% of population)","3.6","OCTOBER",145,3,"High Poverty",148
"2004","West Bank and Gaza","Poverty headcount ratio at $3.65 a day (2017 PPP) (% of population)","3.6","SEPTEMBER",112,11,"High Poverty",123
"2004","West Bank and Gaza","Poverty headcount ratio at $3.65 a day (2017 PPP) (% of population)","3.6","JANUARY",27,15,"High Poverty",42
"2004","West Bank and Gaza","Poverty headcount ratio at $3.65 a day (2017 PPP) (% of population)","3.6","FEBRUARY",54,11,"High Poverty",65
"2004","West Bank and Gaza","Poverty headcount ratio at $3.65 a day (2017 PPP) (% of population)","3.6","NOVEMBER",42,3,"High Poverty",45
"2004","West Bank and Gaza","Poverty headcount ratio at $3.65 a day (2017 PPP) (% of population)","3.6","MARCH",79,11,"High Poverty",90
"2004","West Bank and Gaza","Poverty gap at $2.15 a day (2017 PPP) (%)","0.1","JUNE",59,3,"Low Poverty",62
"2004","West Bank and Gaza","Poverty gap at $2.15 a day (2017 PPP) (%)","0.1","DECEMBER",61,8,"Low Poverty",69
"2004","West Bank and Gaza","Poverty gap at $2.15 a day (2017 PPP) (%)","0.1","AUGUST",39,17,"Low Poverty",56
"2004","West Bank and Gaza","Poverty gap at $2.15 a day (2017 PPP) (%)","0.1","JULY",0,0,"Low Poverty",0
"2004","West Bank and Gaza","Poverty gap at $2.15 a day (2017 PPP) (%)","0.1","APRIL",55,3,"Low Poverty",58
"2004","West Bank and Gaza","Poverty gap at $2.15 a day (2017 PPP) (%)","0.1","MAY",113,19,"Low Poverty",132
"2004","West Bank and Gaza","Poverty gap at $2.15 a day (2017 PPP) (%)","0.1","OCTOBER",145,3,"Low Poverty",148
"2004","West Bank and Gaza","Poverty gap at $2.15 a day (2017 PPP) (%)","0.1","SEPTEMBER",112,11,"Low Poverty",123
"2004","West Bank and Gaza","Poverty gap at $2.15 a day (2017 PPP) (%)","0.1","JANUARY",27,15,"Low Poverty",42
"2004","West Bank and Gaza","Poverty gap at $2.15 a day (2017 PPP) (%)","0.1","FEBRUARY",54,11,"Low Poverty",65
"2004","West Bank and Gaza","Poverty gap at $2.15 a day (2017 PPP) (%)","0.1","NOVEMBER",42,3,"Low Poverty",45
"2004","West Bank and Gaza","Poverty gap at $2.15 a day (2017 PPP) (%)","0.1","MARCH",79,11,"Low Poverty",90
"2004","West Bank and Gaza","Poverty headcount ratio at $6.85 a day (2017 PPP) (% of population)","23.6","JUNE",59,3,"High Poverty",62
"2004","West Bank and Gaza","Poverty headcount ratio at $6.85 a day (2017 PPP) (% of population)","23.6","DECEMBER",61,8,"High Poverty",69
"2004","West Bank and Gaza","Poverty headcount ratio at $6.85 a day (2017 PPP) (% of population)","23.6","AUGUST",39,17,"High Poverty",56
"2004","West Bank and Gaza","Poverty headcount ratio at $6.85 a day (2017 PPP) (% of population)","23.6","JULY",0,0,"High Poverty",0
"2004","West Bank and Gaza","Poverty headcount ratio at $6.85 a day (2017 PPP) (% of population)","23.6","APRIL",55,3,"High Poverty",58
"2004","West Bank and Gaza","Poverty headcount ratio at $6.85 a day (2017 PPP) (% of population)","23.6","MAY",113,19,"High Poverty",132
"2004","West Bank and Gaza","Poverty headcount ratio at $6.85 a day (2017 PPP) (% of population)","23.6","OCTOBER",145,3,"High Poverty",148
"2004","West Bank and Gaza","Poverty headcount ratio at $6.85 a day (2017 PPP) (% of population)","23.6","SEPTEMBER",112,11,"High Poverty",123
"2004","West Bank and Gaza","Poverty headcount ratio at $6.85 a day (2017 PPP) (% of population)","23.6","JANUARY",27,15,"High Poverty",42
"2004","West Bank and Gaza","Poverty headcount ratio at $6.85 a day (2017 PPP) (% of population)","23.6","FEBRUARY",54,11,"High Poverty",65
"2004","West Bank and Gaza","Poverty headcount ratio at $6.85 a day (2017 PPP) (% of population)","23.6","NOVEMBER",42,3,"High Poverty",45
"2004","West Bank and Gaza","Poverty headcount ratio at $6.85 a day (2017 PPP) (% of population)","23.6","MARCH",79,11,"High Poverty",90
"2004","West Bank and Gaza","Poverty gap at $3.65 a day (2017 PPP) (%)","0.9","JUNE",59,3,"Low Poverty",62
"2004","West Bank and Gaza","Poverty gap at $3.65 a day (2017 PPP) (%)","0.9","DECEMBER",61,8,"Low Poverty",69
"2004","West Bank and Gaza","Poverty gap at $3.65 a day (2017 PPP) (%)","0.9","AUGUST",39,17,"Low Poverty",56
"2004","West Bank and Gaza","Poverty gap at $3.65 a day (2017 PPP) (%)","0.9","JULY",0,0,"Low Poverty",0
"2004","West Bank and Gaza","Poverty gap at $3.65 a day (2017 PPP) (%)","0.9","APRIL",55,3,"Low Poverty",58
"2004","West Bank and Gaza","Poverty gap at $3.65 a day (2017 PPP) (%)","0.9","MAY",113,19,"Low Poverty",132
"2004","West Bank and Gaza","Poverty gap at $3.65 a day (2017 PPP) (%)","0.9","OCTOBER",145,3,"Low Poverty",148
"2004","West Bank and Gaza","Poverty gap at $3.65 a day (2017 PPP) (%)","0.9","SEPTEMBER",112,11,"Low Poverty",123
"2004","West Bank and Gaza","Poverty gap at $3.65 a day (2017 PPP) (%)","0.9","JANUARY",27,15,"Low Poverty",42
"2004","West Bank and Gaza","Poverty gap at $3.65 a day (2017 PPP) (%)","0.9","FEBRUARY",54,11,"Low Poverty",65
"2004","West Bank and Gaza","Poverty gap at $3.65 a day (2017 PPP) (%)","0.9","NOVEMBER",42,3,"Low Poverty",45
"2004","West Bank and Gaza","Poverty gap at $3.65 a day (2017 PPP) (%)","0.9","MARCH",79,11,"Low Poverty",90
"2005","West Bank and Gaza","Proportion of people living below 50 percent of median income (%)","11.8","NOVEMBER",15,1,"Medium Poverty",16
"2005","West Bank and Gaza","Proportion of people living below 50 percent of median income (%)","11.8","OCTOBER",22,10,"Medium Poverty",32
"2005","West Bank and Gaza","Proportion of people living below 50 percent of median income (%)","11.8","SEPTEMBER",17,1,"Medium Poverty",18
"2005","West Bank and Gaza","Proportion of people living below 50 percent of median income (%)","11.8","DECEMBER",20,8,"Medium Poverty",28
"2005","West Bank and Gaza","Proportion of people living below 50 percent of median income (%)","11.8","JULY",25,8,"Medium Poverty",33
"2005","West Bank and Gaza","Proportion of people living below 50 percent of median income (%)","11.8","JUNE",5,4,"Medium Poverty",9
"2005","West Bank and Gaza","Proportion of people living below 50 percent of median income (%)","11.8","MAY",10,1,"Medium Poverty",11
"2005","West Bank and Gaza","Proportion of people living below 50 percent of median income (%)","11.8","AUGUST",11,0,"Medium Poverty",11
"2005","West Bank and Gaza","Proportion of people living below 50 percent of median income (%)","11.8","MARCH",1,0,"Medium Poverty",1
"2005","West Bank and Gaza","Proportion of people living below 50 percent of median income (%)","11.8","FEBRUARY",9,5,"Medium Poverty",14
"2005","West Bank and Gaza","Proportion of people living below 50 percent of median income (%)","11.8","JANUARY",50,13,"Medium Poverty",63
"2005","West Bank and Gaza","Proportion of people living below 50 percent of median income (%)","11.8","APRIL",5,0,"Medium Poverty",5
"2005","West Bank and Gaza","Income share held by third 20%","16.1","NOVEMBER",15,1,"Medium Poverty",16
"2005","West Bank and Gaza","Income share held by third 20%","16.1","OCTOBER",22,10,"Medium Poverty",32
"2005","West Bank and Gaza","Income share held by third 20%","16.1","SEPTEMBER",17,1,"Medium Poverty",18
"2005","West Bank and Gaza","Income share held by third 20%","16.1","DECEMBER",20,8,"Medium Poverty",28
"2005","West Bank and Gaza","Income share held by third 20%","16.1","JULY",25,8,"Medium Poverty",33
"2005","West Bank and Gaza","Income share held by third 20%","16.1","JUNE",5,4,"Medium Poverty",9
"2005","West Bank and Gaza","Income share held by third 20%","16.1","MAY",10,1,"Medium Poverty",11
"2005","West Bank and Gaza","Income share held by third 20%","16.1","AUGUST",11,0,"Medium Poverty",11
"2005","West Bank and Gaza","Income share held by third 20%","16.1","MARCH",1,0,"Medium Poverty",1
"2005","West Bank and Gaza","Income share held by third 20%","16.1","FEBRUARY",9,5,"Medium Poverty",14
"2005","West Bank and Gaza","Income share held by third 20%","16.1","JANUARY",50,13,"Medium Poverty",63
"2005","West Bank and Gaza","Income share held by third 20%","16.1","APRIL",5,0,"Medium Poverty",5
"2005","West Bank and Gaza","Poverty headcount ratio at $3.65 a day (2017 PPP) (% of population)","3.2","NOVEMBER",15,1,"High Poverty",16
"2005","West Bank and Gaza","Poverty headcount ratio at $3.65 a day (2017 PPP) (% of population)","3.2","OCTOBER",22,10,"High Poverty",32
"2005","West Bank and Gaza","Poverty headcount ratio at $3.65 a day (2017 PPP) (% of population)","3.2","SEPTEMBER",17,1,"High Poverty",18
"2005","West Bank and Gaza","Poverty headcount ratio at $3.65 a day (2017 PPP) (% of population)","3.2","DECEMBER",20,8,"High Poverty",28
"2005","West Bank and Gaza","Poverty headcount ratio at $3.65 a day (2017 PPP) (% of population)","3.2","JULY",25,8,"High Poverty",33
"2005","West Bank and Gaza","Poverty headcount ratio at $3.65 a day (2017 PPP) (% of population)","3.2","JUNE",5,4,"High Poverty",9
"2005","West Bank and Gaza","Poverty headcount ratio at $3.65 a day (2017 PPP) (% of population)","3.2","MAY",10,1,"High Poverty",11
"2005","West Bank and Gaza","Poverty headcount ratio at $3.65 a day (2017 PPP) (% of population)","3.2","AUGUST",11,0,"High Poverty",11
"2005","West Bank and Gaza","Poverty headcount ratio at $3.65 a day (2017 PPP) (% of population)","3.2","MARCH",1,0,"High Poverty",1
"2005","West Bank and Gaza","Poverty headcount ratio at $3.65 a day (2017 PPP) (% of population)","3.2","FEBRUARY",9,5,"High Poverty",14
"2005","West Bank and Gaza","Poverty headcount ratio at $3.65 a day (2017 PPP) (% of population)","3.2","JANUARY",50,13,"High Poverty",63
"2005","West Bank and Gaza","Poverty headcount ratio at $3.65 a day (2017 PPP) (% of population)","3.2","APRIL",5,0,"High Poverty",5
"2005","West Bank and Gaza","Income share held by fourth 20%","22.5","NOVEMBER",15,1,"High Poverty",16
"2005","West Bank and Gaza","Income share held by fourth 20%","22.5","OCTOBER",22,10,"High Poverty",32
"2005","West Bank and Gaza","Income share held by fourth 20%","22.5","SEPTEMBER",17,1,"High Poverty",18
"2005","West Bank and Gaza","Income share held by fourth 20%","22.5","DECEMBER",20,8,"High Poverty",28
"2005","West Bank and Gaza","Income share held by fourth 20%","22.5","JULY",25,8,"High Poverty",33
"2005","West Bank and Gaza","Income share held by fourth 20%","22.5","JUNE",5,4,"High Poverty",9
"2005","West Bank and Gaza","Income share held by fourth 20%","22.5","MAY",10,1,"High Poverty",11
"2005","West Bank and Gaza","Income share held by fourth 20%","22.5","AUGUST",11,0,"High Poverty",11
"2005","West Bank and Gaza","Income share held by fourth 20%","22.5","MARCH",1,0,"High Poverty",1
"2005","West Bank and Gaza","Income share held by fourth 20%","22.5","FEBRUARY",9,5,"High Poverty",14
"2005","West Bank and Gaza","Income share held by fourth 20%","22.5","JANUARY",50,13,"High Poverty",63
"2005","West Bank and Gaza","Income share held by fourth 20%","22.5","APRIL",5,0,"High Poverty",5
"2005","West Bank and Gaza","Income share held by highest 20%","42.3","NOVEMBER",15,1,"High Poverty",16
"2005","West Bank and Gaza","Income share held by highest 20%","42.3","OCTOBER",22,10,"High Poverty",32
"2005","West Bank and Gaza","Income share held by highest 20%","42.3","SEPTEMBER",17,1,"High Poverty",18
"2005","West Bank and Gaza","Income share held by highest 20%","42.3","DECEMBER",20,8,"High Poverty",28
"2005","West Bank and Gaza","Income share held by highest 20%","42.3","JULY",25,8,"High Poverty",33
"2005","West Bank and Gaza","Income share held by highest 20%","42.3","JUNE",5,4,"High Poverty",9
"2005","West Bank and Gaza","Income share held by highest 20%","42.3","MAY",10,1,"High Poverty",11
"2005","West Bank and Gaza","Income share held by highest 20%","42.3","AUGUST",11,0,"High Poverty",11
"2005","West Bank and Gaza","Income share held by highest 20%","42.3","MARCH",1,0,"High Poverty",1
"2005","West Bank and Gaza","Income share held by highest 20%","42.3","FEBRUARY",9,5,"High Poverty",14
"2005","West Bank and Gaza","Income share held by highest 20%","42.3","JANUARY",50,13,"High Poverty",63
"2005","West Bank and Gaza","Income share held by highest 20%","42.3","APRIL",5,0,"High Poverty",5
"2005","West Bank and Gaza","Poverty headcount ratio at $2.15 a day (2017 PPP) (% of population)","0.2","NOVEMBER",15,1,"Low Poverty",16
"2005","West Bank and Gaza","Poverty headcount ratio at $2.15 a day (2017 PPP) (% of population)","0.2","OCTOBER",22,10,"Low Poverty",32
"2005","West Bank and Gaza","Poverty headcount ratio at $2.15 a day (2017 PPP) (% of population)","0.2","SEPTEMBER",17,1,"Low Poverty",18
"2005","West Bank and Gaza","Poverty headcount ratio at $2.15 a day (2017 PPP) (% of population)","0.2","DECEMBER",20,8,"Low Poverty",28
"2005","West Bank and Gaza","Poverty headcount ratio at $2.15 a day (2017 PPP) (% of population)","0.2","JULY",25,8,"Low Poverty",33
"2005","West Bank and Gaza","Poverty headcount ratio at $2.15 a day (2017 PPP) (% of population)","0.2","JUNE",5,4,"Low Poverty",9
"2005","West Bank and Gaza","Poverty headcount ratio at $2.15 a day (2017 PPP) (% of population)","0.2","MAY",10,1,"Low Poverty",11
"2005","West Bank and Gaza","Poverty headcount ratio at $2.15 a day (2017 PPP) (% of population)","0.2","AUGUST",11,0,"Low Poverty",11
"2005","West Bank and Gaza","Poverty headcount ratio at $2.15 a day (2017 PPP) (% of population)","0.2","MARCH",1,0,"Low Poverty",1
"2005","West Bank and Gaza","Poverty headcount ratio at $2.15 a day (2017 PPP) (% of population)","0.2","FEBRUARY",9,5,"Low Poverty",14
"2005","West Bank and Gaza","Poverty headcount ratio at $2.15 a day (2017 PPP) (% of population)","0.2","JANUARY",50,13,"Low Poverty",63
"2005","West Bank and Gaza","Poverty headcount ratio at $2.15 a day (2017 PPP) (% of population)","0.2","APRIL",5,0,"Low Poverty",5
"2005","West Bank and Gaza","Income share held by second 20%","11.8","NOVEMBER",15,1,"Medium Poverty",16
"2005","West Bank and Gaza","Income share held by second 20%","11.8","OCTOBER",22,10,"Medium Poverty",32
"2005","West Bank and Gaza","Income share held by second 20%","11.8","SEPTEMBER",17,1,"Medium Poverty",18
"2005","West Bank and Gaza","Income share held by second 20%","11.8","DECEMBER",20,8,"Medium Poverty",28
"2005","West Bank and Gaza","Income share held by second 20%","11.8","JULY",25,8,"Medium Poverty",33
"2005","West Bank and Gaza","Income share held by second 20%","11.8","JUNE",5,4,"Medium Poverty",9
"2005","West Bank and Gaza","Income share held by second 20%","11.8","MAY",10,1,"Medium Poverty",11
"2005","West Bank and Gaza","Income share held by second 20%","11.8","AUGUST",11,0,"Medium Poverty",11
"2005","West Bank and Gaza","Income share held by second 20%","11.8","MARCH",1,0,"Medium Poverty",1
"2005","West Bank and Gaza","Income share held by second 20%","11.8","FEBRUARY",9,5,"Medium Poverty",14
"2005","West Bank and Gaza","Income share held by second 20%","11.8","JANUARY",50,13,"Medium Poverty",63
"2005","West Bank and Gaza","Income share held by second 20%","11.8","APRIL",5,0,"Medium Poverty",5
"2005","West Bank and Gaza","Income share held by highest 10%","26.7","NOVEMBER",15,1,"High Poverty",16
"2005","West Bank and Gaza","Income share held by highest 10%","26.7","OCTOBER",22,10,"High Poverty",32
"2005","West Bank and Gaza","Income share held by highest 10%","26.7","SEPTEMBER",17,1,"High Poverty",18
"2005","West Bank and Gaza","Income share held by highest 10%","26.7","DECEMBER",20,8,"High Poverty",28
"2005","West Bank and Gaza","Income share held by highest 10%","26.7","JULY",25,8,"High Poverty",33
"2005","West Bank and Gaza","Income share held by highest 10%","26.7","JUNE",5,4,"High Poverty",9
"2005","West Bank and Gaza","Income share held by highest 10%","26.7","MAY",10,1,"High Poverty",11
"2005","West Bank and Gaza","Income share held by highest 10%","26.7","AUGUST",11,0,"High Poverty",11
"2005","West Bank and Gaza","Income share held by highest 10%","26.7","MARCH",1,0,"High Poverty",1
"2005","West Bank and Gaza","Income share held by highest 10%","26.7","FEBRUARY",9,5,"High Poverty",14
"2005","West Bank and Gaza","Income share held by highest 10%","26.7","JANUARY",50,13,"High Poverty",63
"2005","West Bank and Gaza","Income share held by highest 10%","26.7","APRIL",5,0,"High Poverty",5
"2005","West Bank and Gaza","Gini index","34.7","NOVEMBER",15,1,"High Poverty",16
"2005","West Bank and Gaza","Gini index","34.7","OCTOBER",22,10,"High Poverty",32
"2005","West Bank and Gaza","Gini index","34.7","SEPTEMBER",17,1,"High Poverty",18
"2005","West Bank and Gaza","Gini index","34.7","DECEMBER",20,8,"High Poverty",28
"2005","West Bank and Gaza","Gini index","34.7","JULY",25,8,"High Poverty",33
"2005","West Bank and Gaza","Gini index","34.7","JUNE",5,4,"High Poverty",9
"2005","West Bank and Gaza","Gini index","34.7","MAY",10,1,"High Poverty",11
"2005","West Bank and Gaza","Gini index","34.7","AUGUST",11,0,"High Poverty",11
"2005","West Bank and Gaza","Gini index","34.7","MARCH",1,0,"High Poverty",1
"2005","West Bank and Gaza","Gini index","34.7","FEBRUARY",9,5,"High Poverty",14
"2005","West Bank and Gaza","Gini index","34.7","JANUARY",50,13,"High Poverty",63
"2005","West Bank and Gaza","Gini index","34.7","APRIL",5,0,"High Poverty",5
"2005","West Bank and Gaza","Income share held by lowest 20%","7.3","NOVEMBER",15,1,"High Poverty",16
"2005","West Bank and Gaza","Income share held by lowest 20%","7.3","OCTOBER",22,10,"High Poverty",32
"2005","West Bank and Gaza","Income share held by lowest 20%","7.3","SEPTEMBER",17,1,"High Poverty",18
"2005","West Bank and Gaza","Income share held by lowest 20%","7.3","DECEMBER",20,8,"High Poverty",28
"2005","West Bank and Gaza","Income share held by lowest 20%","7.3","JULY",25,8,"High Poverty",33
"2005","West Bank and Gaza","Income share held by lowest 20%","7.3","JUNE",5,4,"High Poverty",9
"2005","West Bank and Gaza","Income share held by lowest 20%","7.3","MAY",10,1,"High Poverty",11
"2005","West Bank and Gaza","Income share held by lowest 20%","7.3","AUGUST",11,0,"High Poverty",11
"2005","West Bank and Gaza","Income share held by lowest 20%","7.3","MARCH",1,0,"High Poverty",1
"2005","West Bank and Gaza","Income share held by lowest 20%","7.3","FEBRUARY",9,5,"High Poverty",14
"2005","West Bank and Gaza","Income share held by lowest 20%","7.3","JANUARY",50,13,"High Poverty",63
"2005","West Bank and Gaza","Income share held by lowest 20%","7.3","APRIL",5,0,"High Poverty",5
"2005","West Bank and Gaza","Poverty gap at $3.65 a day (2017 PPP) (%)","0.6","NOVEMBER",15,1,"Low Poverty",16
"2005","West Bank and Gaza","Poverty gap at $3.65 a day (2017 PPP) (%)","0.6","OCTOBER",22,10,"Low Poverty",32
"2005","West Bank and Gaza","Poverty gap at $3.65 a day (2017 PPP) (%)","0.6","SEPTEMBER",17,1,"Low Poverty",18
"2005","West Bank and Gaza","Poverty gap at $3.65 a day (2017 PPP) (%)","0.6","DECEMBER",20,8,"Low Poverty",28
"2005","West Bank and Gaza","Poverty gap at $3.65 a day (2017 PPP) (%)","0.6","JULY",25,8,"Low Poverty",33
"2005","West Bank and Gaza","Poverty gap at $3.65 a day (2017 PPP) (%)","0.6","JUNE",5,4,"Low Poverty",9
"2005","West Bank and Gaza","Poverty gap at $3.65 a day (2017 PPP) (%)","0.6","MAY",10,1,"Low Poverty",11
"2005","West Bank and Gaza","Poverty gap at $3.65 a day (2017 PPP) (%)","0.6","AUGUST",11,0,"Low Poverty",11
"2005","West Bank and Gaza","Poverty gap at $3.65 a day (2017 PPP) (%)","0.6","MARCH",1,0,"Low Poverty",1
"2005","West Bank and Gaza","Poverty gap at $3.65 a day (2017 PPP) (%)","0.6","FEBRUARY",9,5,"Low Poverty",14
"2005","West Bank and Gaza","Poverty gap at $3.65 a day (2017 PPP) (%)","0.6","JANUARY",50,13,"Low Poverty",63
"2005","West Bank and Gaza","Poverty gap at $3.65 a day (2017 PPP) (%)","0.6","APRIL",5,0,"Low Poverty",5
"2005","West Bank and Gaza","Poverty gap at $6.85 a day (2017 PPP) (%)","5.7","NOVEMBER",15,1,"High Poverty",16
"2005","West Bank and Gaza","Poverty gap at $6.85 a day (2017 PPP) (%)","5.7","OCTOBER",22,10,"High Poverty",32
"2005","West Bank and Gaza","Poverty gap at $6.85 a day (2017 PPP) (%)","5.7","SEPTEMBER",17,1,"High Poverty",18
"2005","West Bank and Gaza","Poverty gap at $6.85 a day (2017 PPP) (%)","5.7","DECEMBER",20,8,"High Poverty",28
"2005","West Bank and Gaza","Poverty gap at $6.85 a day (2017 PPP) (%)","5.7","JULY",25,8,"High Poverty",33
"2005","West Bank and Gaza","Poverty gap at $6.85 a day (2017 PPP) (%)","5.7","JUNE",5,4,"High Poverty",9
"2005","West Bank and Gaza","Poverty gap at $6.85 a day (2017 PPP) (%)","5.7","MAY",10,1,"High Poverty",11
"2005","West Bank and Gaza","Poverty gap at $6.85 a day (2017 PPP) (%)","5.7","AUGUST",11,0,"High Poverty",11
"2005","West Bank and Gaza","Poverty gap at $6.85 a day (2017 PPP) (%)","5.7","MARCH",1,0,"High Poverty",1
"2005","West Bank and Gaza","Poverty gap at $6.85 a day (2017 PPP) (%)","5.7","FEBRUARY",9,5,"High Poverty",14
"2005","West Bank and Gaza","Poverty gap at $6.85 a day (2017 PPP) (%)","5.7","JANUARY",50,13,"High Poverty",63
"2005","West Bank and Gaza","Poverty gap at $6.85 a day (2017 PPP) (%)","5.7","APRIL",5,0,"High Poverty",5
"2005","West Bank and Gaza","Poverty headcount ratio at $6.85 a day (2017 PPP) (% of population)","21.5","NOVEMBER",15,1,"High Poverty",16
"2005","West Bank and Gaza","Poverty headcount ratio at $6.85 a day (2017 PPP) (% of population)","21.5","OCTOBER",22,10,"High Poverty",32
"2005","West Bank and Gaza","Poverty headcount ratio at $6.85 a day (2017 PPP) (% of population)","21.5","SEPTEMBER",17,1,"High Poverty",18
"2005","West Bank and Gaza","Poverty headcount ratio at $6.85 a day (2017 PPP) (% of population)","21.5","DECEMBER",20,8,"High Poverty",28
"2005","West Bank and Gaza","Poverty headcount ratio at $6.85 a day (2017 PPP) (% of population)","21.5","JULY",25,8,"High Poverty",33
"2005","West Bank and Gaza","Poverty headcount ratio at $6.85 a day (2017 PPP) (% of population)","21.5","JUNE",5,4,"High Poverty",9
"2005","West Bank and Gaza","Poverty headcount ratio at $6.85 a day (2017 PPP) (% of population)","21.5","MAY",10,1,"High Poverty",11
"2005","West Bank and Gaza","Poverty headcount ratio at $6.85 a day (2017 PPP) (% of population)","21.5","AUGUST",11,0,"High Poverty",11
"2005","West Bank and Gaza","Poverty headcount ratio at $6.85 a day (2017 PPP) (% of population)","21.5","MARCH",1,0,"High Poverty",1
"2005","West Bank and Gaza","Poverty headcount ratio at $6.85 a day (2017 PPP) (% of population)","21.5","FEBRUARY",9,5,"High Poverty",14
"2005","West Bank and Gaza","Poverty headcount ratio at $6.85 a day (2017 PPP) (% of population)","21.5","JANUARY",50,13,"High Poverty",63
"2005","West Bank and Gaza","Poverty headcount ratio at $6.85 a day (2017 PPP) (% of population)","21.5","APRIL",5,0,"High Poverty",5
"2005","West Bank and Gaza","Poverty gap at $2.15 a day (2017 PPP) (%)","0","NOVEMBER",15,1,"Low Poverty",16
"2005","West Bank and Gaza","Poverty gap at $2.15 a day (2017 PPP) (%)","0","OCTOBER",22,10,"Low Poverty",32
"2005","West Bank and Gaza","Poverty gap at $2.15 a day (2017 PPP) (%)","0","SEPTEMBER",17,1,"Low Poverty",18
"2005","West Bank and Gaza","Poverty gap at $2.15 a day (2017 PPP) (%)","0","DECEMBER",20,8,"Low Poverty",28
"2005","West Bank and Gaza","Poverty gap at $2.15 a day (2017 PPP) (%)","0","JULY",25,8,"Low Poverty",33
"2005","West Bank and Gaza","Poverty gap at $2.15 a day (2017 PPP) (%)","0","JUNE",5,4,"Low Poverty",9
"2005","West Bank and Gaza","Poverty gap at $2.15 a day (2017 PPP) (%)","0","MAY",10,1,"Low Poverty",11
"2005","West Bank and Gaza","Poverty gap at $2.15 a day (2017 PPP) (%)","0","AUGUST",11,0,"Low Poverty",11
"2005","West Bank and Gaza","Poverty gap at $2.15 a day (2017 PPP) (%)","0","MARCH",1,0,"Low Poverty",1
"2005","West Bank and Gaza","Poverty gap at $2.15 a day (2017 PPP) (%)","0","FEBRUARY",9,5,"Low Poverty",14
"2005","West Bank and Gaza","Poverty gap at $2.15 a day (2017 PPP) (%)","0","JANUARY",50,13,"Low Poverty",63
"2005","West Bank and Gaza","Poverty gap at $2.15 a day (2017 PPP) (%)","0","APRIL",5,0,"Low Poverty",5
"2005","West Bank and Gaza","Income share held by lowest 10%","2.9","NOVEMBER",15,1,"Medium Poverty",16
"2005","West Bank and Gaza","Income share held by lowest 10%","2.9","OCTOBER",22,10,"Medium Poverty",32
"2005","West Bank and Gaza","Income share held by lowest 10%","2.9","SEPTEMBER",17,1,"Medium Poverty",18
"2005","West Bank and Gaza","Income share held by lowest 10%","2.9","DECEMBER",20,8,"Medium Poverty",28
"2005","West Bank and Gaza","Income share held by lowest 10%","2.9","JULY",25,8,"Medium Poverty",33
"2005","West Bank and Gaza","Income share held by lowest 10%","2.9","JUNE",5,4,"Medium Poverty",9
"2005","West Bank and Gaza","Income share held by lowest 10%","2.9","MAY",10,1,"Medium Poverty",11
"2005","West Bank and Gaza","Income share held by lowest 10%","2.9","AUGUST",11,0,"Medium Poverty",11
"2005","West Bank and Gaza","Income share held by lowest 10%","2.9","MARCH",1,0,"Medium Poverty",1
"2005","West Bank and Gaza","Income share held by lowest 10%","2.9","FEBRUARY",9,5,"Medium Poverty",14
"2005","West Bank and Gaza","Income share held by lowest 10%","2.9","JANUARY",50,13,"Medium Poverty",63
"2005","West Bank and Gaza","Income share held by lowest 10%","2.9","APRIL",5,0,"Medium Poverty",5
"2006","West Bank and Gaza","Income share held by highest 10%","27.1","APRIL",31,7,"High Poverty",38
"2006","West Bank and Gaza","Income share held by highest 10%","27.1","JUNE",43,3,"High Poverty",46
"2006","West Bank and Gaza","Income share held by highest 10%","27.1","MAY",37,0,"High Poverty",37
"2006","West Bank and Gaza","Income share held by highest 10%","27.1","FEBRUARY",31,1,"High Poverty",32
"2006","West Bank and Gaza","Income share held by highest 10%","27.1","NOVEMBER",134,0,"High Poverty",134
"2006","West Bank and Gaza","Income share held by highest 10%","27.1","OCTOBER",61,0,"High Poverty",61
"2006","West Bank and Gaza","Income share held by highest 10%","27.1","SEPTEMBER",32,1,"High Poverty",33
"2006","West Bank and Gaza","Income share held by highest 10%","27.1","AUGUST",74,1,"High Poverty",75
"2006","West Bank and Gaza","Income share held by highest 10%","27.1","JULY",180,2,"High Poverty",182
"2006","West Bank and Gaza","Income share held by highest 10%","27.1","MARCH",15,5,"High Poverty",20
"2006","West Bank and Gaza","Income share held by highest 10%","27.1","DECEMBER",14,0,"High Poverty",14
"2006","West Bank and Gaza","Income share held by highest 10%","27.1","JANUARY",13,0,"High Poverty",13
"2006","West Bank and Gaza","Proportion of people living below 50 percent of median income (%)","10","APRIL",31,7,"Medium Poverty",38
"2006","West Bank and Gaza","Proportion of people living below 50 percent of median income (%)","10","JUNE",43,3,"Medium Poverty",46
"2006","West Bank and Gaza","Proportion of people living below 50 percent of median income (%)","10","MAY",37,0,"Medium Poverty",37
"2006","West Bank and Gaza","Proportion of people living below 50 percent of median income (%)","10","FEBRUARY",31,1,"Medium Poverty",32
"2006","West Bank and Gaza","Proportion of people living below 50 percent of median income (%)","10","NOVEMBER",134,0,"Medium Poverty",134
"2006","West Bank and Gaza","Proportion of people living below 50 percent of median income (%)","10","OCTOBER",61,0,"Medium Poverty",61
"2006","West Bank and Gaza","Proportion of people living below 50 percent of median income (%)","10","SEPTEMBER",32,1,"Medium Poverty",33
"2006","West Bank and Gaza","Proportion of people living below 50 percent of median income (%)","10","AUGUST",74,1,"Medium Poverty",75
"2006","West Bank and Gaza","Proportion of people living below 50 percent of median income (%)","10","JULY",180,2,"Medium Poverty",182
"2006","West Bank and Gaza","Proportion of people living below 50 percent of median income (%)","10","MARCH",15,5,"Medium Poverty",20
"2006","West Bank and Gaza","Proportion of people living below 50 percent of median income (%)","10","DECEMBER",14,0,"Medium Poverty",14
"2006","West Bank and Gaza","Proportion of people living below 50 percent of median income (%)","10","JANUARY",13,0,"Medium Poverty",13
"2006","West Bank and Gaza","Income share held by highest 20%","42.2","APRIL",31,7,"High Poverty",38
"2006","West Bank and Gaza","Income share held by highest 20%","42.2","JUNE",43,3,"High Poverty",46
"2006","West Bank and Gaza","Income share held by highest 20%","42.2","MAY",37,0,"High Poverty",37
"2006","West Bank and Gaza","Income share held by highest 20%","42.2","FEBRUARY",31,1,"High Poverty",32
"2006","West Bank and Gaza","Income share held by highest 20%","42.2","NOVEMBER",134,0,"High Poverty",134
"2006","West Bank and Gaza","Income share held by highest 20%","42.2","OCTOBER",61,0,"High Poverty",61
"2006","West Bank and Gaza","Income share held by highest 20%","42.2","SEPTEMBER",32,1,"High Poverty",33
"2006","West Bank and Gaza","Income share held by highest 20%","42.2","AUGUST",74,1,"High Poverty",75
"2006","West Bank and Gaza","Income share held by highest 20%","42.2","JULY",180,2,"High Poverty",182
"2006","West Bank and Gaza","Income share held by highest 20%","42.2","MARCH",15,5,"High Poverty",20
"2006","West Bank and Gaza","Income share held by highest 20%","42.2","DECEMBER",14,0,"High Poverty",14
"2006","West Bank and Gaza","Income share held by highest 20%","42.2","JANUARY",13,0,"High Poverty",13
"2006","West Bank and Gaza","Poverty headcount ratio at $6.85 a day (2017 PPP) (% of population)","19.7","APRIL",31,7,"Medium Poverty",38
"2006","West Bank and Gaza","Poverty headcount ratio at $6.85 a day (2017 PPP) (% of population)","19.7","JUNE",43,3,"Medium Poverty",46
"2006","West Bank and Gaza","Poverty headcount ratio at $6.85 a day (2017 PPP) (% of population)","19.7","MAY",37,0,"Medium Poverty",37
"2006","West Bank and Gaza","Poverty headcount ratio at $6.85 a day (2017 PPP) (% of population)","19.7","FEBRUARY",31,1,"Medium Poverty",32
"2006","West Bank and Gaza","Poverty headcount ratio at $6.85 a day (2017 PPP) (% of population)","19.7","NOVEMBER",134,0,"Medium Poverty",134
"2006","West Bank and Gaza","Poverty headcount ratio at $6.85 a day (2017 PPP) (% of population)","19.7","OCTOBER",61,0,"Medium Poverty",61
"2006","West Bank and Gaza","Poverty headcount ratio at $6.85 a day (2017 PPP) (% of population)","19.7","SEPTEMBER",32,1,"Medium Poverty",33
"2006","West Bank and Gaza","Poverty headcount ratio at $6.85 a day (2017 PPP) (% of population)","19.7","AUGUST",74,1,"Medium Poverty",75
"2006","West Bank and Gaza","Poverty headcount ratio at $6.85 a day (2017 PPP) (% of population)","19.7","JULY",180,2,"Medium Poverty",182
"2006","West Bank and Gaza","Poverty headcount ratio at $6.85 a day (2017 PPP) (% of population)","19.7","MARCH",15,5,"Medium Poverty",20
"2006","West Bank and Gaza","Poverty headcount ratio at $6.85 a day (2017 PPP) (% of population)","19.7","DECEMBER",14,0,"Medium Poverty",14
"2006","West Bank and Gaza","Poverty headcount ratio at $6.85 a day (2017 PPP) (% of population)","19.7","JANUARY",13,0,"Medium Poverty",13
"2006","West Bank and Gaza","Poverty gap at $3.65 a day (2017 PPP) (%)","0.3","APRIL",31,7,"Low Poverty",38
"2006","West Bank and Gaza","Poverty gap at $3.65 a day (2017 PPP) (%)","0.3","JUNE",43,3,"Low Poverty",46
"2006","West Bank and Gaza","Poverty gap at $3.65 a day (2017 PPP) (%)","0.3","MAY",37,0,"Low Poverty",37
"2006","West Bank and Gaza","Poverty gap at $3.65 a day (2017 PPP) (%)","0.3","FEBRUARY",31,1,"Low Poverty",32
"2006","West Bank and Gaza","Poverty gap at $3.65 a day (2017 PPP) (%)","0.3","NOVEMBER",134,0,"Low Poverty",134
"2006","West Bank and Gaza","Poverty gap at $3.65 a day (2017 PPP) (%)","0.3","OCTOBER",61,0,"Low Poverty",61
"2006","West Bank and Gaza","Poverty gap at $3.65 a day (2017 PPP) (%)","0.3","SEPTEMBER",32,1,"Low Poverty",33
"2006","West Bank and Gaza","Poverty gap at $3.65 a day (2017 PPP) (%)","0.3","AUGUST",74,1,"Low Poverty",75
"2006","West Bank and Gaza","Poverty gap at $3.65 a day (2017 PPP) (%)","0.3","JULY",180,2,"Low Poverty",182
"2006","West Bank and Gaza","Poverty gap at $3.65 a day (2017 PPP) (%)","0.3","MARCH",15,5,"Low Poverty",20
"2006","West Bank and Gaza","Poverty gap at $3.65 a day (2017 PPP) (%)","0.3","DECEMBER",14,0,"Low Poverty",14
"2006","West Bank and Gaza","Poverty gap at $3.65 a day (2017 PPP) (%)","0.3","JANUARY",13,0,"Low Poverty",13
"2006","West Bank and Gaza","Income share held by fourth 20%","21.8","APRIL",31,7,"High Poverty",38
"2006","West Bank and Gaza","Income share held by fourth 20%","21.8","JUNE",43,3,"High Poverty",46
"2006","West Bank and Gaza","Income share held by fourth 20%","21.8","MAY",37,0,"High Poverty",37
"2006","West Bank and Gaza","Income share held by fourth 20%","21.8","FEBRUARY",31,1,"High Poverty",32
"2006","West Bank and Gaza","Income share held by fourth 20%","21.8","NOVEMBER",134,0,"High Poverty",134
"2006","West Bank and Gaza","Income share held by fourth 20%","21.8","OCTOBER",61,0,"High Poverty",61
"2006","West Bank and Gaza","Income share held by fourth 20%","21.8","SEPTEMBER",32,1,"High Poverty",33
"2006","West Bank and Gaza","Income share held by fourth 20%","21.8","AUGUST",74,1,"High Poverty",75
"2006","West Bank and Gaza","Income share held by fourth 20%","21.8","JULY",180,2,"High Poverty",182
"2006","West Bank and Gaza","Income share held by fourth 20%","21.8","MARCH",15,5,"High Poverty",20
"2006","West Bank and Gaza","Income share held by fourth 20%","21.8","DECEMBER",14,0,"High Poverty",14
"2006","West Bank and Gaza","Income share held by fourth 20%","21.8","JANUARY",13,0,"High Poverty",13
"2006","West Bank and Gaza","Population living in slums (% of urban population)","29.07112","APRIL",31,7,"High Poverty",38
"2006","West Bank and Gaza","Population living in slums (% of urban population)","29.07112","JUNE",43,3,"High Poverty",46
"2006","West Bank and Gaza","Population living in slums (% of urban population)","29.07112","MAY",37,0,"High Poverty",37
"2006","West Bank and Gaza","Population living in slums (% of urban population)","29.07112","FEBRUARY",31,1,"High Poverty",32
"2006","West Bank and Gaza","Population living in slums (% of urban population)","29.07112","NOVEMBER",134,0,"High Poverty",134
"2006","West Bank and Gaza","Population living in slums (% of urban population)","29.07112","OCTOBER",61,0,"High Poverty",61
"2006","West Bank and Gaza","Population living in slums (% of urban population)","29.07112","SEPTEMBER",32,1,"High Poverty",33
"2006","West Bank and Gaza","Population living in slums (% of urban population)","29.07112","AUGUST",74,1,"High Poverty",75
"2006","West Bank and Gaza","Population living in slums (% of urban population)","29.07112","JULY",180,2,"High Poverty",182
"2006","West Bank and Gaza","Population living in slums (% of urban population)","29.07112","MARCH",15,5,"High Poverty",20
"2006","West Bank and Gaza","Population living in slums (% of urban population)","29.07112","DECEMBER",14,0,"High Poverty",14
"2006","West Bank and Gaza","Population living in slums (% of urban population)","29.07112","JANUARY",13,0,"High Poverty",13
"2006","West Bank and Gaza","Income share held by second 20%","12.1","APRIL",31,7,"Medium Poverty",38
"2006","West Bank and Gaza","Income share held by second 20%","12.1","JUNE",43,3,"Medium Poverty",46
"2006","West Bank and Gaza","Income share held by second 20%","12.1","MAY",37,0,"Medium Poverty",37
"2006","West Bank and Gaza","Income share held by second 20%","12.1","FEBRUARY",31,1,"Medium Poverty",32
"2006","West Bank and Gaza","Income share held by second 20%","12.1","NOVEMBER",134,0,"Medium Poverty",134
"2006","West Bank and Gaza","Income share held by second 20%","12.1","OCTOBER",61,0,"Medium Poverty",61
"2006","West Bank and Gaza","Income share held by second 20%","12.1","SEPTEMBER",32,1,"Medium Poverty",33
"2006","West Bank and Gaza","Income share held by second 20%","12.1","AUGUST",74,1,"Medium Poverty",75
"2006","West Bank and Gaza","Income share held by second 20%","12.1","JULY",180,2,"Medium Poverty",182
"2006","West Bank and Gaza","Income share held by second 20%","12.1","MARCH",15,5,"Medium Poverty",20
"2006","West Bank and Gaza","Income share held by second 20%","12.1","DECEMBER",14,0,"Medium Poverty",14
"2006","West Bank and Gaza","Income share held by second 20%","12.1","JANUARY",13,0,"Medium Poverty",13
"2006","West Bank and Gaza","Income share held by lowest 10%","3.2","APRIL",31,7,"High Poverty",38
"2006","West Bank and Gaza","Income share held by lowest 10%","3.2","JUNE",43,3,"High Poverty",46
"2006","West Bank and Gaza","Income share held by lowest 10%","3.2","MAY",37,0,"High Poverty",37
"2006","West Bank and Gaza","Income share held by lowest 10%","3.2","FEBRUARY",31,1,"High Poverty",32
"2006","West Bank and Gaza","Income share held by lowest 10%","3.2","NOVEMBER",134,0,"High Poverty",134
"2006","West Bank and Gaza","Income share held by lowest 10%","3.2","OCTOBER",61,0,"High Poverty",61
"2006","West Bank and Gaza","Income share held by lowest 10%","3.2","SEPTEMBER",32,1,"High Poverty",33
"2006","West Bank and Gaza","Income share held by lowest 10%","3.2","AUGUST",74,1,"High Poverty",75
"2006","West Bank and Gaza","Income share held by lowest 10%","3.2","JULY",180,2,"High Poverty",182
"2006","West Bank and Gaza","Income share held by lowest 10%","3.2","MARCH",15,5,"High Poverty",20
"2006","West Bank and Gaza","Income share held by lowest 10%","3.2","DECEMBER",14,0,"High Poverty",14
"2006","West Bank and Gaza","Income share held by lowest 10%","3.2","JANUARY",13,0,"High Poverty",13
"2006","West Bank and Gaza","Poverty headcount ratio at $3.65 a day (2017 PPP) (% of population)","2","APRIL",31,7,"Medium Poverty",38
"2006","West Bank and Gaza","Poverty headcount ratio at $3.65 a day (2017 PPP) (% of population)","2","JUNE",43,3,"Medium Poverty",46
"2006","West Bank and Gaza","Poverty headcount ratio at $3.65 a day (2017 PPP) (% of population)","2","MAY",37,0,"Medium Poverty",37
"2006","West Bank and Gaza","Poverty headcount ratio at $3.65 a day (2017 PPP) (% of population)","2","FEBRUARY",31,1,"Medium Poverty",32
"2006","West Bank and Gaza","Poverty headcount ratio at $3.65 a day (2017 PPP) (% of population)","2","NOVEMBER",134,0,"Medium Poverty",134
"2006","West Bank and Gaza","Poverty headcount ratio at $3.65 a day (2017 PPP) (% of population)","2","OCTOBER",61,0,"Medium Poverty",61
"2006","West Bank and Gaza","Poverty headcount ratio at $3.65 a day (2017 PPP) (% of population)","2","SEPTEMBER",32,1,"Medium Poverty",33
"2006","West Bank and Gaza","Poverty headcount ratio at $3.65 a day (2017 PPP) (% of population)","2","AUGUST",74,1,"Medium Poverty",75
"2006","West Bank and Gaza","Poverty headcount ratio at $3.65 a day (2017 PPP) (% of population)","2","JULY",180,2,"Medium Poverty",182
"2006","West Bank and Gaza","Poverty headcount ratio at $3.65 a day (2017 PPP) (% of population)","2","MARCH",15,5,"Medium Poverty",20
"2006","West Bank and Gaza","Poverty headcount ratio at $3.65 a day (2017 PPP) (% of population)","2","DECEMBER",14,0,"Medium Poverty",14
"2006","West Bank and Gaza","Poverty headcount ratio at $3.65 a day (2017 PPP) (% of population)","2","JANUARY",13,0,"Medium Poverty",13
"2006","West Bank and Gaza","Poverty gap at $6.85 a day (2017 PPP) (%)","4.7","APRIL",31,7,"High Poverty",38
"2006","West Bank and Gaza","Poverty gap at $6.85 a day (2017 PPP) (%)","4.7","JUNE",43,3,"High Poverty",46
"2006","West Bank and Gaza","Poverty gap at $6.85 a day (2017 PPP) (%)","4.7","MAY",37,0,"High Poverty",37
"2006","West Bank and Gaza","Poverty gap at $6.85 a day (2017 PPP) (%)","4.7","FEBRUARY",31,1,"High Poverty",32
"2006","West Bank and Gaza","Poverty gap at $6.85 a day (2017 PPP) (%)","4.7","NOVEMBER",134,0,"High Poverty",134
"2006","West Bank and Gaza","Poverty gap at $6.85 a day (2017 PPP) (%)","4.7","OCTOBER",61,0,"High Poverty",61
"2006","West Bank and Gaza","Poverty gap at $6.85 a day (2017 PPP) (%)","4.7","SEPTEMBER",32,1,"High Poverty",33
"2006","West Bank and Gaza","Poverty gap at $6.85 a day (2017 PPP) (%)","4.7","AUGUST",74,1,"High Poverty",75
"2006","West Bank and Gaza","Poverty gap at $6.85 a day (2017 PPP) (%)","4.7","JULY",180,2,"High Poverty",182
"2006","West Bank and Gaza","Poverty gap at $6.85 a day (2017 PPP) (%)","4.7","MARCH",15,5,"High Poverty",20
"2006","West Bank and Gaza","Poverty gap at $6.85 a day (2017 PPP) (%)","4.7","DECEMBER",14,0,"High Poverty",14
"2006","West Bank and Gaza","Poverty gap at $6.85 a day (2017 PPP) (%)","4.7","JANUARY",13,0,"High Poverty",13
"2006","West Bank and Gaza","Income share held by lowest 20%","7.8","APRIL",31,7,"High Poverty",38
"2006","West Bank and Gaza","Income share held by lowest 20%","7.8","JUNE",43,3,"High Poverty",46
"2006","West Bank and Gaza","Income share held by lowest 20%","7.8","MAY",37,0,"High Poverty",37
"2006","West Bank and Gaza","Income share held by lowest 20%","7.8","FEBRUARY",31,1,"High Poverty",32
"2006","West Bank and Gaza","Income share held by lowest 20%","7.8","NOVEMBER",134,0,"High Poverty",134
"2006","West Bank and Gaza","Income share held by lowest 20%","7.8","OCTOBER",61,0,"High Poverty",61
"2006","West Bank and Gaza","Income share held by lowest 20%","7.8","SEPTEMBER",32,1,"High Poverty",33
"2006","West Bank and Gaza","Income share held by lowest 20%","7.8","AUGUST",74,1,"High Poverty",75
"2006","West Bank and Gaza","Income share held by lowest 20%","7.8","JULY",180,2,"High Poverty",182
"2006","West Bank and Gaza","Income share held by lowest 20%","7.8","MARCH",15,5,"High Poverty",20
"2006","West Bank and Gaza","Income share held by lowest 20%","7.8","DECEMBER",14,0,"High Poverty",14
"2006","West Bank and Gaza","Income share held by lowest 20%","7.8","JANUARY",13,0,"High Poverty",13
"2006","West Bank and Gaza","Gini index","34","APRIL",31,7,"High Poverty",38
"2006","West Bank and Gaza","Gini index","34","JUNE",43,3,"High Poverty",46
"2006","West Bank and Gaza","Gini index","34","MAY",37,0,"High Poverty",37
"2006","West Bank and Gaza","Gini index","34","FEBRUARY",31,1,"High Poverty",32
"2006","West Bank and Gaza","Gini index","34","NOVEMBER",134,0,"High Poverty",134
"2006","West Bank and Gaza","Gini index","34","OCTOBER",61,0,"High Poverty",61
"2006","West Bank and Gaza","Gini index","34","SEPTEMBER",32,1,"High Poverty",33
"2006","West Bank and Gaza","Gini index","34","AUGUST",74,1,"High Poverty",75
"2006","West Bank and Gaza","Gini index","34","JULY",180,2,"High Poverty",182
"2006","West Bank and Gaza","Gini index","34","MARCH",15,5,"High Poverty",20
"2006","West Bank and Gaza","Gini index","34","DECEMBER",14,0,"High Poverty",14
"2006","West Bank and Gaza","Gini index","34","JANUARY",13,0,"High Poverty",13
"2006","West Bank and Gaza","Income share held by third 20%","16.1","APRIL",31,7,"Medium Poverty",38
"2006","West Bank and Gaza","Income share held by third 20%","16.1","JUNE",43,3,"Medium Poverty",46
"2006","West Bank and Gaza","Income share held by third 20%","16.1","MAY",37,0,"Medium Poverty",37
"2006","West Bank and Gaza","Income share held by third 20%","16.1","FEBRUARY",31,1,"Medium Poverty",32
"2006","West Bank and Gaza","Income share held by third 20%","16.1","NOVEMBER",134,0,"Medium Poverty",134
"2006","West Bank and Gaza","Income share held by third 20%","16.1","OCTOBER",61,0,"Medium Poverty",61
"2006","West Bank and Gaza","Income share held by third 20%","16.1","SEPTEMBER",32,1,"Medium Poverty",33
"2006","West Bank and Gaza","Income share held by third 20%","16.1","AUGUST",74,1,"Medium Poverty",75
"2006","West Bank and Gaza","Income share held by third 20%","16.1","JULY",180,2,"Medium Poverty",182
"2006","West Bank and Gaza","Income share held by third 20%","16.1","MARCH",15,5,"Medium Poverty",20
"2006","West Bank and Gaza","Income share held by third 20%","16.1","DECEMBER",14,0,"Medium Poverty",14
"2006","West Bank and Gaza","Income share held by third 20%","16.1","JANUARY",13,0,"Medium Poverty",13
"2006","West Bank and Gaza","Poverty headcount ratio at $2.15 a day (2017 PPP) (% of population)","0.3","APRIL",31,7,"Low Poverty",38
"2006","West Bank and Gaza","Poverty headcount ratio at $2.15 a day (2017 PPP) (% of population)","0.3","JUNE",43,3,"Low Poverty",46
"2006","West Bank and Gaza","Poverty headcount ratio at $2.15 a day (2017 PPP) (% of population)","0.3","MAY",37,0,"Low Poverty",37
"2006","West Bank and Gaza","Poverty headcount ratio at $2.15 a day (2017 PPP) (% of population)","0.3","FEBRUARY",31,1,"Low Poverty",32
"2006","West Bank and Gaza","Poverty headcount ratio at $2.15 a day (2017 PPP) (% of population)","0.3","NOVEMBER",134,0,"Low Poverty",134
"2006","West Bank and Gaza","Poverty headcount ratio at $2.15 a day (2017 PPP) (% of population)","0.3","OCTOBER",61,0,"Low Poverty",61
"2006","West Bank and Gaza","Poverty headcount ratio at $2.15 a day (2017 PPP) (% of population)","0.3","SEPTEMBER",32,1,"Low Poverty",33
"2006","West Bank and Gaza","Poverty headcount ratio at $2.15 a day (2017 PPP) (% of population)","0.3","AUGUST",74,1,"Low Poverty",75
"2006","West Bank and Gaza","Poverty headcount ratio at $2.15 a day (2017 PPP) (% of population)","0.3","JULY",180,2,"Low Poverty",182
"2006","West Bank and Gaza","Poverty headcount ratio at $2.15 a day (2017 PPP) (% of population)","0.3","MARCH",15,5,"Low Poverty",20
"2006","West Bank and Gaza","Poverty headcount ratio at $2.15 a day (2017 PPP) (% of population)","0.3","DECEMBER",14,0,"Low Poverty",14
"2006","West Bank and Gaza","Poverty headcount ratio at $2.15 a day (2017 PPP) (% of population)","0.3","JANUARY",13,0,"Low Poverty",13
"2006","West Bank and Gaza","Poverty gap at $2.15 a day (2017 PPP) (%)","0","APRIL",31,7,"Low Poverty",38
"2006","West Bank and Gaza","Poverty gap at $2.15 a day (2017 PPP) (%)","0","JUNE",43,3,"Low Poverty",46
"2006","West Bank and Gaza","Poverty gap at $2.15 a day (2017 PPP) (%)","0","MAY",37,0,"Low Poverty",37
"2006","West Bank and Gaza","Poverty gap at $2.15 a day (2017 PPP) (%)","0","FEBRUARY",31,1,"Low Poverty",32
"2006","West Bank and Gaza","Poverty gap at $2.15 a day (2017 PPP) (%)","0","NOVEMBER",134,0,"Low Poverty",134
"2006","West Bank and Gaza","Poverty gap at $2.15 a day (2017 PPP) (%)","0","OCTOBER",61,0,"Low Poverty",61
"2006","West Bank and Gaza","Poverty gap at $2.15 a day (2017 PPP) (%)","0","SEPTEMBER",32,1,"Low Poverty",33
"2006","West Bank and Gaza","Poverty gap at $2.15 a day (2017 PPP) (%)","0","AUGUST",74,1,"Low Poverty",75
"2006","West Bank and Gaza","Poverty gap at $2.15 a day (2017 PPP) (%)","0","JULY",180,2,"Low Poverty",182
"2006","West Bank and Gaza","Poverty gap at $2.15 a day (2017 PPP) (%)","0","MARCH",15,5,"Low Poverty",20
"2006","West Bank and Gaza","Poverty gap at $2.15 a day (2017 PPP) (%)","0","DECEMBER",14,0,"Low Poverty",14
"2006","West Bank and Gaza","Poverty gap at $2.15 a day (2017 PPP) (%)","0","JANUARY",13,0,"Low Poverty",13
"2007","West Bank and Gaza","Proportion of people living below 50 percent of median income (%)","11.3","SEPTEMBER",34,0,"Medium Poverty",34
"2007","West Bank and Gaza","Proportion of people living below 50 percent of median income (%)","11.3","JULY",27,1,"Medium Poverty",28
"2007","West Bank and Gaza","Proportion of people living below 50 percent of median income (%)","11.3","OCTOBER",36,2,"Medium Poverty",38
"2007","West Bank and Gaza","Proportion of people living below 50 percent of median income (%)","11.3","MAY",62,2,"Medium Poverty",64
"2007","West Bank and Gaza","Proportion of people living below 50 percent of median income (%)","11.3","AUGUST",47,0,"Medium Poverty",47
"2007","West Bank and Gaza","Proportion of people living below 50 percent of median income (%)","11.3","MARCH",9,0,"Medium Poverty",9
"2007","West Bank and Gaza","Proportion of people living below 50 percent of median income (%)","11.3","JUNE",40,0,"Medium Poverty",40
"2007","West Bank and Gaza","Proportion of people living below 50 percent of median income (%)","11.3","JANUARY",10,3,"Medium Poverty",13
"2007","West Bank and Gaza","Proportion of people living below 50 percent of median income (%)","11.3","APRIL",16,0,"Medium Poverty",16
"2007","West Bank and Gaza","Proportion of people living below 50 percent of median income (%)","11.3","DECEMBER",61,2,"Medium Poverty",63
"2007","West Bank and Gaza","Proportion of people living below 50 percent of median income (%)","11.3","FEBRUARY",12,1,"Medium Poverty",13
"2007","West Bank and Gaza","Proportion of people living below 50 percent of median income (%)","11.3","NOVEMBER",31,1,"Medium Poverty",32
"2007","West Bank and Gaza","Income share held by lowest 20%","7.1","SEPTEMBER",34,0,"High Poverty",34
"2007","West Bank and Gaza","Income share held by lowest 20%","7.1","JULY",27,1,"High Poverty",28
"2007","West Bank and Gaza","Income share held by lowest 20%","7.1","OCTOBER",36,2,"High Poverty",38
"2007","West Bank and Gaza","Income share held by lowest 20%","7.1","MAY",62,2,"High Poverty",64
"2007","West Bank and Gaza","Income share held by lowest 20%","7.1","AUGUST",47,0,"High Poverty",47
"2007","West Bank and Gaza","Income share held by lowest 20%","7.1","MARCH",9,0,"High Poverty",9
"2007","West Bank and Gaza","Income share held by lowest 20%","7.1","JUNE",40,0,"High Poverty",40
"2007","West Bank and Gaza","Income share held by lowest 20%","7.1","JANUARY",10,3,"High Poverty",13
"2007","West Bank and Gaza","Income share held by lowest 20%","7.1","APRIL",16,0,"High Poverty",16
"2007","West Bank and Gaza","Income share held by lowest 20%","7.1","DECEMBER",61,2,"High Poverty",63
"2007","West Bank and Gaza","Income share held by lowest 20%","7.1","FEBRUARY",12,1,"High Poverty",13
"2007","West Bank and Gaza","Income share held by lowest 20%","7.1","NOVEMBER",31,1,"High Poverty",32
"2007","West Bank and Gaza","Income share held by lowest 10%","2.8","SEPTEMBER",34,0,"Medium Poverty",34
"2007","West Bank and Gaza","Income share held by lowest 10%","2.8","JULY",27,1,"Medium Poverty",28
"2007","West Bank and Gaza","Income share held by lowest 10%","2.8","OCTOBER",36,2,"Medium Poverty",38
"2007","West Bank and Gaza","Income share held by lowest 10%","2.8","MAY",62,2,"Medium Poverty",64
"2007","West Bank and Gaza","Income share held by lowest 10%","2.8","AUGUST",47,0,"Medium Poverty",47
"2007","West Bank and Gaza","Income share held by lowest 10%","2.8","MARCH",9,0,"Medium Poverty",9
"2007","West Bank and Gaza","Income share held by lowest 10%","2.8","JUNE",40,0,"Medium Poverty",40
"2007","West Bank and Gaza","Income share held by lowest 10%","2.8","JANUARY",10,3,"Medium Poverty",13
"2007","West Bank and Gaza","Income share held by lowest 10%","2.8","APRIL",16,0,"Medium Poverty",16
"2007","West Bank and Gaza","Income share held by lowest 10%","2.8","DECEMBER",61,2,"Medium Poverty",63
"2007","West Bank and Gaza","Income share held by lowest 10%","2.8","FEBRUARY",12,1,"Medium Poverty",13
"2007","West Bank and Gaza","Income share held by lowest 10%","2.8","NOVEMBER",31,1,"Medium Poverty",32
"2007","West Bank and Gaza","Income share held by fourth 20%","22.3","SEPTEMBER",34,0,"High Poverty",34
"2007","West Bank and Gaza","Income share held by fourth 20%","22.3","JULY",27,1,"High Poverty",28
"2007","West Bank and Gaza","Income share held by fourth 20%","22.3","OCTOBER",36,2,"High Poverty",38
"2007","West Bank and Gaza","Income share held by fourth 20%","22.3","MAY",62,2,"High Poverty",64
"2007","West Bank and Gaza","Income share held by fourth 20%","22.3","AUGUST",47,0,"High Poverty",47
"2007","West Bank and Gaza","Income share held by fourth 20%","22.3","MARCH",9,0,"High Poverty",9
"2007","West Bank and Gaza","Income share held by fourth 20%","22.3","JUNE",40,0,"High Poverty",40
"2007","West Bank and Gaza","Income share held by fourth 20%","22.3","JANUARY",10,3,"High Poverty",13
"2007","West Bank and Gaza","Income share held by fourth 20%","22.3","APRIL",16,0,"High Poverty",16
"2007","West Bank and Gaza","Income share held by fourth 20%","22.3","DECEMBER",61,2,"High Poverty",63
"2007","West Bank and Gaza","Income share held by fourth 20%","22.3","FEBRUARY",12,1,"High Poverty",13
"2007","West Bank and Gaza","Income share held by fourth 20%","22.3","NOVEMBER",31,1,"High Poverty",32
"2007","West Bank and Gaza","Income share held by highest 20%","43","SEPTEMBER",34,0,"High Poverty",34
"2007","West Bank and Gaza","Income share held by highest 20%","43","JULY",27,1,"High Poverty",28
"2007","West Bank and Gaza","Income share held by highest 20%","43","OCTOBER",36,2,"High Poverty",38
"2007","West Bank and Gaza","Income share held by highest 20%","43","MAY",62,2,"High Poverty",64
"2007","West Bank and Gaza","Income share held by highest 20%","43","AUGUST",47,0,"High Poverty",47
"2007","West Bank and Gaza","Income share held by highest 20%","43","MARCH",9,0,"High Poverty",9
"2007","West Bank and Gaza","Income share held by highest 20%","43","JUNE",40,0,"High Poverty",40
"2007","West Bank and Gaza","Income share held by highest 20%","43","JANUARY",10,3,"High Poverty",13
"2007","West Bank and Gaza","Income share held by highest 20%","43","APRIL",16,0,"High Poverty",16
"2007","West Bank and Gaza","Income share held by highest 20%","43","DECEMBER",61,2,"High Poverty",63
"2007","West Bank and Gaza","Income share held by highest 20%","43","FEBRUARY",12,1,"High Poverty",13
"2007","West Bank and Gaza","Income share held by highest 20%","43","NOVEMBER",31,1,"High Poverty",32
"2007","West Bank and Gaza","Poverty gap at $3.65 a day (2017 PPP) (%)","1.3","SEPTEMBER",34,0,"Low Poverty",34
"2007","West Bank and Gaza","Poverty gap at $3.65 a day (2017 PPP) (%)","1.3","JULY",27,1,"Low Poverty",28
"2007","West Bank and Gaza","Poverty gap at $3.65 a day (2017 PPP) (%)","1.3","OCTOBER",36,2,"Low Poverty",38
"2007","West Bank and Gaza","Poverty gap at $3.65 a day (2017 PPP) (%)","1.3","MAY",62,2,"Low Poverty",64
"2007","West Bank and Gaza","Poverty gap at $3.65 a day (2017 PPP) (%)","1.3","AUGUST",47,0,"Low Poverty",47
"2007","West Bank and Gaza","Poverty gap at $3.65 a day (2017 PPP) (%)","1.3","MARCH",9,0,"Low Poverty",9
"2007","West Bank and Gaza","Poverty gap at $3.65 a day (2017 PPP) (%)","1.3","JUNE",40,0,"Low Poverty",40
"2007","West Bank and Gaza","Poverty gap at $3.65 a day (2017 PPP) (%)","1.3","JANUARY",10,3,"Low Poverty",13
"2007","West Bank and Gaza","Poverty gap at $3.65 a day (2017 PPP) (%)","1.3","APRIL",16,0,"Low Poverty",16
"2007","West Bank and Gaza","Poverty gap at $3.65 a day (2017 PPP) (%)","1.3","DECEMBER",61,2,"Low Poverty",63
"2007","West Bank and Gaza","Poverty gap at $3.65 a day (2017 PPP) (%)","1.3","FEBRUARY",12,1,"Low Poverty",13
"2007","West Bank and Gaza","Poverty gap at $3.65 a day (2017 PPP) (%)","1.3","NOVEMBER",31,1,"Low Poverty",32
"2007","West Bank and Gaza","Income share held by second 20%","11.6","SEPTEMBER",34,0,"Medium Poverty",34
"2007","West Bank and Gaza","Income share held by second 20%","11.6","JULY",27,1,"Medium Poverty",28
"2007","West Bank and Gaza","Income share held by second 20%","11.6","OCTOBER",36,2,"Medium Poverty",38
"2007","West Bank and Gaza","Income share held by second 20%","11.6","MAY",62,2,"Medium Poverty",64
"2007","West Bank and Gaza","Income share held by second 20%","11.6","AUGUST",47,0,"Medium Poverty",47
"2007","West Bank and Gaza","Income share held by second 20%","11.6","MARCH",9,0,"Medium Poverty",9
"2007","West Bank and Gaza","Income share held by second 20%","11.6","JUNE",40,0,"Medium Poverty",40
"2007","West Bank and Gaza","Income share held by second 20%","11.6","JANUARY",10,3,"Medium Poverty",13
"2007","West Bank and Gaza","Income share held by second 20%","11.6","APRIL",16,0,"Medium Poverty",16
"2007","West Bank and Gaza","Income share held by second 20%","11.6","DECEMBER",61,2,"Medium Poverty",63
"2007","West Bank and Gaza","Income share held by second 20%","11.6","FEBRUARY",12,1,"Medium Poverty",13
"2007","West Bank and Gaza","Income share held by second 20%","11.6","NOVEMBER",31,1,"Medium Poverty",32
"2007","West Bank and Gaza","Income share held by highest 10%","27.6","SEPTEMBER",34,0,"High Poverty",34
"2007","West Bank and Gaza","Income share held by highest 10%","27.6","JULY",27,1,"High Poverty",28
"2007","West Bank and Gaza","Income share held by highest 10%","27.6","OCTOBER",36,2,"High Poverty",38
"2007","West Bank and Gaza","Income share held by highest 10%","27.6","MAY",62,2,"High Poverty",64
"2007","West Bank and Gaza","Income share held by highest 10%","27.6","AUGUST",47,0,"High Poverty",47
"2007","West Bank and Gaza","Income share held by highest 10%","27.6","MARCH",9,0,"High Poverty",9
"2007","West Bank and Gaza","Income share held by highest 10%","27.6","JUNE",40,0,"High Poverty",40
"2007","West Bank and Gaza","Income share held by highest 10%","27.6","JANUARY",10,3,"High Poverty",13
"2007","West Bank and Gaza","Income share held by highest 10%","27.6","APRIL",16,0,"High Poverty",16
"2007","West Bank and Gaza","Income share held by highest 10%","27.6","DECEMBER",61,2,"High Poverty",63
"2007","West Bank and Gaza","Income share held by highest 10%","27.6","FEBRUARY",12,1,"High Poverty",13
"2007","West Bank and Gaza","Income share held by highest 10%","27.6","NOVEMBER",31,1,"High Poverty",32
"2007","West Bank and Gaza","Gini index","35.6","SEPTEMBER",34,0,"High Poverty",34
"2007","West Bank and Gaza","Gini index","35.6","JULY",27,1,"High Poverty",28
"2007","West Bank and Gaza","Gini index","35.6","OCTOBER",36,2,"High Poverty",38
"2007","West Bank and Gaza","Gini index","35.6","MAY",62,2,"High Poverty",64
"2007","West Bank and Gaza","Gini index","35.6","AUGUST",47,0,"High Poverty",47
"2007","West Bank and Gaza","Gini index","35.6","MARCH",9,0,"High Poverty",9
"2007","West Bank and Gaza","Gini index","35.6","JUNE",40,0,"High Poverty",40
"2007","West Bank and Gaza","Gini index","35.6","JANUARY",10,3,"High Poverty",13
"2007","West Bank and Gaza","Gini index","35.6","APRIL",16,0,"High Poverty",16
"2007","West Bank and Gaza","Gini index","35.6","DECEMBER",61,2,"High Poverty",63
"2007","West Bank and Gaza","Gini index","35.6","FEBRUARY",12,1,"High Poverty",13
"2007","West Bank and Gaza","Gini index","35.6","NOVEMBER",31,1,"High Poverty",32
"2007","West Bank and Gaza","Income share held by third 20%","16.1","SEPTEMBER",34,0,"Medium Poverty",34
"2007","West Bank and Gaza","Income share held by third 20%","16.1","JULY",27,1,"Medium Poverty",28
"2007","West Bank and Gaza","Income share held by third 20%","16.1","OCTOBER",36,2,"Medium Poverty",38
"2007","West Bank and Gaza","Income share held by third 20%","16.1","MAY",62,2,"Medium Poverty",64
"2007","West Bank and Gaza","Income share held by third 20%","16.1","AUGUST",47,0,"Medium Poverty",47
"2007","West Bank and Gaza","Income share held by third 20%","16.1","MARCH",9,0,"Medium Poverty",9
"2007","West Bank and Gaza","Income share held by third 20%","16.1","JUNE",40,0,"Medium Poverty",40
"2007","West Bank and Gaza","Income share held by third 20%","16.1","JANUARY",10,3,"Medium Poverty",13
"2007","West Bank and Gaza","Income share held by third 20%","16.1","APRIL",16,0,"Medium Poverty",16
"2007","West Bank and Gaza","Income share held by third 20%","16.1","DECEMBER",61,2,"Medium Poverty",63
"2007","West Bank and Gaza","Income share held by third 20%","16.1","FEBRUARY",12,1,"Medium Poverty",13
"2007","West Bank and Gaza","Income share held by third 20%","16.1","NOVEMBER",31,1,"Medium Poverty",32
"2007","West Bank and Gaza","Poverty headcount ratio at $2.15 a day (2017 PPP) (% of population)","1.4","SEPTEMBER",34,0,"Low Poverty",34
"2007","West Bank and Gaza","Poverty headcount ratio at $2.15 a day (2017 PPP) (% of population)","1.4","JULY",27,1,"Low Poverty",28
"2007","West Bank and Gaza","Poverty headcount ratio at $2.15 a day (2017 PPP) (% of population)","1.4","OCTOBER",36,2,"Low Poverty",38
"2007","West Bank and Gaza","Poverty headcount ratio at $2.15 a day (2017 PPP) (% of population)","1.4","MAY",62,2,"Low Poverty",64
"2007","West Bank and Gaza","Poverty headcount ratio at $2.15 a day (2017 PPP) (% of population)","1.4","AUGUST",47,0,"Low Poverty",47
"2007","West Bank and Gaza","Poverty headcount ratio at $2.15 a day (2017 PPP) (% of population)","1.4","MARCH",9,0,"Low Poverty",9
"2007","West Bank and Gaza","Poverty headcount ratio at $2.15 a day (2017 PPP) (% of population)","1.4","JUNE",40,0,"Low Poverty",40
"2007","West Bank and Gaza","Poverty headcount ratio at $2.15 a day (2017 PPP) (% of population)","1.4","JANUARY",10,3,"Low Poverty",13
"2007","West Bank and Gaza","Poverty headcount ratio at $2.15 a day (2017 PPP) (% of population)","1.4","APRIL",16,0,"Low Poverty",16
"2007","West Bank and Gaza","Poverty headcount ratio at $2.15 a day (2017 PPP) (% of population)","1.4","DECEMBER",61,2,"Low Poverty",63
"2007","West Bank and Gaza","Poverty headcount ratio at $2.15 a day (2017 PPP) (% of population)","1.4","FEBRUARY",12,1,"Low Poverty",13
"2007","West Bank and Gaza","Poverty headcount ratio at $2.15 a day (2017 PPP) (% of population)","1.4","NOVEMBER",31,1,"Low Poverty",32
"2007","West Bank and Gaza","Poverty gap at $6.85 a day (2017 PPP) (%)","7.7","SEPTEMBER",34,0,"High Poverty",34
"2007","West Bank and Gaza","Poverty gap at $6.85 a day (2017 PPP) (%)","7.7","JULY",27,1,"High Poverty",28
"2007","West Bank and Gaza","Poverty gap at $6.85 a day (2017 PPP) (%)","7.7","OCTOBER",36,2,"High Poverty",38
"2007","West Bank and Gaza","Poverty gap at $6.85 a day (2017 PPP) (%)","7.7","MAY",62,2,"High Poverty",64
"2007","West Bank and Gaza","Poverty gap at $6.85 a day (2017 PPP) (%)","7.7","AUGUST",47,0,"High Poverty",47
"2007","West Bank and Gaza","Poverty gap at $6.85 a day (2017 PPP) (%)","7.7","MARCH",9,0,"High Poverty",9
"2007","West Bank and Gaza","Poverty gap at $6.85 a day (2017 PPP) (%)","7.7","JUNE",40,0,"High Poverty",40
"2007","West Bank and Gaza","Poverty gap at $6.85 a day (2017 PPP) (%)","7.7","JANUARY",10,3,"High Poverty",13
"2007","West Bank and Gaza","Poverty gap at $6.85 a day (2017 PPP) (%)","7.7","APRIL",16,0,"High Poverty",16
"2007","West Bank and Gaza","Poverty gap at $6.85 a day (2017 PPP) (%)","7.7","DECEMBER",61,2,"High Poverty",63
"2007","West Bank and Gaza","Poverty gap at $6.85 a day (2017 PPP) (%)","7.7","FEBRUARY",12,1,"High Poverty",13
"2007","West Bank and Gaza","Poverty gap at $6.85 a day (2017 PPP) (%)","7.7","NOVEMBER",31,1,"High Poverty",32
"2007","West Bank and Gaza","Poverty headcount ratio at $6.85 a day (2017 PPP) (% of population)","27.7","SEPTEMBER",34,0,"High Poverty",34
"2007","West Bank and Gaza","Poverty headcount ratio at $6.85 a day (2017 PPP) (% of population)","27.7","JULY",27,1,"High Poverty",28
"2007","West Bank and Gaza","Poverty headcount ratio at $6.85 a day (2017 PPP) (% of population)","27.7","OCTOBER",36,2,"High Poverty",38
"2007","West Bank and Gaza","Poverty headcount ratio at $6.85 a day (2017 PPP) (% of population)","27.7","MAY",62,2,"High Poverty",64
"2007","West Bank and Gaza","Poverty headcount ratio at $6.85 a day (2017 PPP) (% of population)","27.7","AUGUST",47,0,"High Poverty",47
"2007","West Bank and Gaza","Poverty headcount ratio at $6.85 a day (2017 PPP) (% of population)","27.7","MARCH",9,0,"High Poverty",9
"2007","West Bank and Gaza","Poverty headcount ratio at $6.85 a day (2017 PPP) (% of population)","27.7","JUNE",40,0,"High Poverty",40
"2007","West Bank and Gaza","Poverty headcount ratio at $6.85 a day (2017 PPP) (% of population)","27.7","JANUARY",10,3,"High Poverty",13
"2007","West Bank and Gaza","Poverty headcount ratio at $6.85 a day (2017 PPP) (% of population)","27.7","APRIL",16,0,"High Poverty",16
"2007","West Bank and Gaza","Poverty headcount ratio at $6.85 a day (2017 PPP) (% of population)","27.7","DECEMBER",61,2,"High Poverty",63
"2007","West Bank and Gaza","Poverty headcount ratio at $6.85 a day (2017 PPP) (% of population)","27.7","FEBRUARY",12,1,"High Poverty",13
"2007","West Bank and Gaza","Poverty headcount ratio at $6.85 a day (2017 PPP) (% of population)","27.7","NOVEMBER",31,1,"High Poverty",32
"2007","West Bank and Gaza","Poverty gap at $2.15 a day (2017 PPP) (%)","0.2","SEPTEMBER",34,0,"Low Poverty",34
"2007","West Bank and Gaza","Poverty gap at $2.15 a day (2017 PPP) (%)","0.2","JULY",27,1,"Low Poverty",28
"2007","West Bank and Gaza","Poverty gap at $2.15 a day (2017 PPP) (%)","0.2","OCTOBER",36,2,"Low Poverty",38
"2007","West Bank and Gaza","Poverty gap at $2.15 a day (2017 PPP) (%)","0.2","MAY",62,2,"Low Poverty",64
"2007","West Bank and Gaza","Poverty gap at $2.15 a day (2017 PPP) (%)","0.2","AUGUST",47,0,"Low Poverty",47
"2007","West Bank and Gaza","Poverty gap at $2.15 a day (2017 PPP) (%)","0.2","MARCH",9,0,"Low Poverty",9
"2007","West Bank and Gaza","Poverty gap at $2.15 a day (2017 PPP) (%)","0.2","JUNE",40,0,"Low Poverty",40
"2007","West Bank and Gaza","Poverty gap at $2.15 a day (2017 PPP) (%)","0.2","JANUARY",10,3,"Low Poverty",13
"2007","West Bank and Gaza","Poverty gap at $2.15 a day (2017 PPP) (%)","0.2","APRIL",16,0,"Low Poverty",16
"2007","West Bank and Gaza","Poverty gap at $2.15 a day (2017 PPP) (%)","0.2","DECEMBER",61,2,"Low Poverty",63
"2007","West Bank and Gaza","Poverty gap at $2.15 a day (2017 PPP) (%)","0.2","FEBRUARY",12,1,"Low Poverty",13
"2007","West Bank and Gaza","Poverty gap at $2.15 a day (2017 PPP) (%)","0.2","NOVEMBER",31,1,"Low Poverty",32
"2007","West Bank and Gaza","Poverty headcount ratio at $3.65 a day (2017 PPP) (% of population)","5.1","SEPTEMBER",34,0,"High Poverty",34
"2007","West Bank and Gaza","Poverty headcount ratio at $3.65 a day (2017 PPP) (% of population)","5.1","JULY",27,1,"High Poverty",28
"2007","West Bank and Gaza","Poverty headcount ratio at $3.65 a day (2017 PPP) (% of population)","5.1","OCTOBER",36,2,"High Poverty",38
"2007","West Bank and Gaza","Poverty headcount ratio at $3.65 a day (2017 PPP) (% of population)","5.1","MAY",62,2,"High Poverty",64
"2007","West Bank and Gaza","Poverty headcount ratio at $3.65 a day (2017 PPP) (% of population)","5.1","AUGUST",47,0,"High Poverty",47
"2007","West Bank and Gaza","Poverty headcount ratio at $3.65 a day (2017 PPP) (% of population)","5.1","MARCH",9,0,"High Poverty",9
"2007","West Bank and Gaza","Poverty headcount ratio at $3.65 a day (2017 PPP) (% of population)","5.1","JUNE",40,0,"High Poverty",40
"2007","West Bank and Gaza","Poverty headcount ratio at $3.65 a day (2017 PPP) (% of population)","5.1","JANUARY",10,3,"High Poverty",13
"2007","West Bank and Gaza","Poverty headcount ratio at $3.65 a day (2017 PPP) (% of population)","5.1","APRIL",16,0,"High Poverty",16
"2007","West Bank and Gaza","Poverty headcount ratio at $3.65 a day (2017 PPP) (% of population)","5.1","DECEMBER",61,2,"High Poverty",63
"2007","West Bank and Gaza","Poverty headcount ratio at $3.65 a day (2017 PPP) (% of population)","5.1","FEBRUARY",12,1,"High Poverty",13
"2007","West Bank and Gaza","Poverty headcount ratio at $3.65 a day (2017 PPP) (% of population)","5.1","NOVEMBER",31,1,"High Poverty",32
"2008","West Bank and Gaza","Population living in slums (% of urban population)","27.16442","FEBRUARY",79,2,"High Poverty",81
"2008","West Bank and Gaza","Population living in slums (% of urban population)","27.16442","JANUARY",89,1,"High Poverty",90
"2008","West Bank and Gaza","Population living in slums (% of urban population)","27.16442","SEPTEMBER",3,0,"High Poverty",3
"2008","West Bank and Gaza","Population living in slums (% of urban population)","27.16442","AUGUST",0,4,"High Poverty",4
"2008","West Bank and Gaza","Population living in slums (% of urban population)","27.16442","JULY",8,4,"High Poverty",12
"2008","West Bank and Gaza","Population living in slums (% of urban population)","27.16442","JUNE",30,1,"High Poverty",31
"2008","West Bank and Gaza","Population living in slums (% of urban population)","27.16442","MAY",40,2,"High Poverty",42
"2008","West Bank and Gaza","Population living in slums (% of urban population)","27.16442","APRIL",72,8,"High Poverty",80
"2008","West Bank and Gaza","Population living in slums (% of urban population)","27.16442","MARCH",114,12,"High Poverty",126
"2008","West Bank and Gaza","Population living in slums (% of urban population)","27.16442","DECEMBER",432,4,"High Poverty",436
"2008","West Bank and Gaza","Population living in slums (% of urban population)","27.16442","NOVEMBER",15,0,"High Poverty",15
"2008","West Bank and Gaza","Population living in slums (% of urban population)","27.16442","OCTOBER",4,1,"High Poverty",5
"2009","West Bank and Gaza","Income share held by fourth 20%","21.9","JUNE",4,0,"High Poverty",4
"2009","West Bank and Gaza","Income share held by fourth 20%","21.9","JULY",2,0,"High Poverty",2
"2009","West Bank and Gaza","Income share held by fourth 20%","21.9","FEBRUARY",9,0,"High Poverty",9
"2009","West Bank and Gaza","Income share held by fourth 20%","21.9","MAY",6,1,"High Poverty",7
"2009","West Bank and Gaza","Income share held by fourth 20%","21.9","APRIL",6,1,"High Poverty",7
"2009","West Bank and Gaza","Income share held by fourth 20%","21.9","MARCH",9,0,"High Poverty",9
"2009","West Bank and Gaza","Income share held by fourth 20%","21.9","OCTOBER",0,0,"High Poverty",0
"2009","West Bank and Gaza","Income share held by fourth 20%","21.9","JANUARY",978,6,"High Poverty",984
"2009","West Bank and Gaza","Income share held by fourth 20%","21.9","DECEMBER",6,1,"High Poverty",7
"2009","West Bank and Gaza","Income share held by fourth 20%","21.9","NOVEMBER",1,0,"High Poverty",1
"2009","West Bank and Gaza","Income share held by fourth 20%","21.9","AUGUST",6,0,"High Poverty",6
"2009","West Bank and Gaza","Income share held by fourth 20%","21.9","SEPTEMBER",9,0,"High Poverty",9
"2009","West Bank and Gaza","Income share held by second 20%","11.9","JUNE",4,0,"Medium Poverty",4
"2009","West Bank and Gaza","Income share held by second 20%","11.9","JULY",2,0,"Medium Poverty",2
"2009","West Bank and Gaza","Income share held by second 20%","11.9","FEBRUARY",9,0,"Medium Poverty",9
"2009","West Bank and Gaza","Income share held by second 20%","11.9","MAY",6,1,"Medium Poverty",7
"2009","West Bank and Gaza","Income share held by second 20%","11.9","APRIL",6,1,"Medium Poverty",7
"2009","West Bank and Gaza","Income share held by second 20%","11.9","MARCH",9,0,"Medium Poverty",9
"2009","West Bank and Gaza","Income share held by second 20%","11.9","OCTOBER",0,0,"Medium Poverty",0
"2009","West Bank and Gaza","Income share held by second 20%","11.9","JANUARY",978,6,"Medium Poverty",984
"2009","West Bank and Gaza","Income share held by second 20%","11.9","DECEMBER",6,1,"Medium Poverty",7
"2009","West Bank and Gaza","Income share held by second 20%","11.9","NOVEMBER",1,0,"Medium Poverty",1
"2009","West Bank and Gaza","Income share held by second 20%","11.9","AUGUST",6,0,"Medium Poverty",6
"2009","West Bank and Gaza","Income share held by second 20%","11.9","SEPTEMBER",9,0,"Medium Poverty",9
"2009","West Bank and Gaza","Poverty gap at $3.65 a day (2017 PPP) (%)","0.3","JUNE",4,0,"Low Poverty",4
"2009","West Bank and Gaza","Poverty gap at $3.65 a day (2017 PPP) (%)","0.3","JULY",2,0,"Low Poverty",2
"2009","West Bank and Gaza","Poverty gap at $3.65 a day (2017 PPP) (%)","0.3","FEBRUARY",9,0,"Low Poverty",9
"2009","West Bank and Gaza","Poverty gap at $3.65 a day (2017 PPP) (%)","0.3","MAY",6,1,"Low Poverty",7
"2009","West Bank and Gaza","Poverty gap at $3.65 a day (2017 PPP) (%)","0.3","APRIL",6,1,"Low Poverty",7
"2009","West Bank and Gaza","Poverty gap at $3.65 a day (2017 PPP) (%)","0.3","MARCH",9,0,"Low Poverty",9
"2009","West Bank and Gaza","Poverty gap at $3.65 a day (2017 PPP) (%)","0.3","OCTOBER",0,0,"Low Poverty",0
"2009","West Bank and Gaza","Poverty gap at $3.65 a day (2017 PPP) (%)","0.3","JANUARY",978,6,"Low Poverty",984
"2009","West Bank and Gaza","Poverty gap at $3.65 a day (2017 PPP) (%)","0.3","DECEMBER",6,1,"Low Poverty",7
"2009","West Bank and Gaza","Poverty gap at $3.65 a day (2017 PPP) (%)","0.3","NOVEMBER",1,0,"Low Poverty",1
"2009","West Bank and Gaza","Poverty gap at $3.65 a day (2017 PPP) (%)","0.3","AUGUST",6,0,"Low Poverty",6
"2009","West Bank and Gaza","Poverty gap at $3.65 a day (2017 PPP) (%)","0.3","SEPTEMBER",9,0,"Low Poverty",9
"2009","West Bank and Gaza","Gini index","34.5","JUNE",4,0,"High Poverty",4
"2009","West Bank and Gaza","Gini index","34.5","JULY",2,0,"High Poverty",2
"2009","West Bank and Gaza","Gini index","34.5","FEBRUARY",9,0,"High Poverty",9
"2009","West Bank and Gaza","Gini index","34.5","MAY",6,1,"High Poverty",7
"2009","West Bank and Gaza","Gini index","34.5","APRIL",6,1,"High Poverty",7
"2009","West Bank and Gaza","Gini index","34.5","MARCH",9,0,"High Poverty",9
"2009","West Bank and Gaza","Gini index","34.5","OCTOBER",0,0,"High Poverty",0
"2009","West Bank and Gaza","Gini index","34.5","JANUARY",978,6,"High Poverty",984
"2009","West Bank and Gaza","Gini index","34.5","DECEMBER",6,1,"High Poverty",7
"2009","West Bank and Gaza","Gini index","34.5","NOVEMBER",1,0,"High Poverty",1
"2009","West Bank and Gaza","Gini index","34.5","AUGUST",6,0,"High Poverty",6
"2009","West Bank and Gaza","Gini index","34.5","SEPTEMBER",9,0,"High Poverty",9
"2009","West Bank and Gaza","Poverty headcount ratio at $3.65 a day (2017 PPP) (% of population)","1.7","JUNE",4,0,"Low Poverty",4
"2009","West Bank and Gaza","Poverty headcount ratio at $3.65 a day (2017 PPP) (% of population)","1.7","JULY",2,0,"Low Poverty",2
"2009","West Bank and Gaza","Poverty headcount ratio at $3.65 a day (2017 PPP) (% of population)","1.7","FEBRUARY",9,0,"Low Poverty",9
"2009","West Bank and Gaza","Poverty headcount ratio at $3.65 a day (2017 PPP) (% of population)","1.7","MAY",6,1,"Low Poverty",7
"2009","West Bank and Gaza","Poverty headcount ratio at $3.65 a day (2017 PPP) (% of population)","1.7","APRIL",6,1,"Low Poverty",7
"2009","West Bank and Gaza","Poverty headcount ratio at $3.65 a day (2017 PPP) (% of population)","1.7","MARCH",9,0,"Low Poverty",9
"2009","West Bank and Gaza","Poverty headcount ratio at $3.65 a day (2017 PPP) (% of population)","1.7","OCTOBER",0,0,"Low Poverty",0
"2009","West Bank and Gaza","Poverty headcount ratio at $3.65 a day (2017 PPP) (% of population)","1.7","JANUARY",978,6,"Low Poverty",984
"2009","West Bank and Gaza","Poverty headcount ratio at $3.65 a day (2017 PPP) (% of population)","1.7","DECEMBER",6,1,"Low Poverty",7
"2009","West Bank and Gaza","Poverty headcount ratio at $3.65 a day (2017 PPP) (% of population)","1.7","NOVEMBER",1,0,"Low Poverty",1
"2009","West Bank and Gaza","Poverty headcount ratio at $3.65 a day (2017 PPP) (% of population)","1.7","AUGUST",6,0,"Low Poverty",6
"2009","West Bank and Gaza","Poverty headcount ratio at $3.65 a day (2017 PPP) (% of population)","1.7","SEPTEMBER",9,0,"Low Poverty",9
"2009","West Bank and Gaza","Income share held by lowest 20%","7.7","JUNE",4,0,"High Poverty",4
"2009","West Bank and Gaza","Income share held by lowest 20%","7.7","JULY",2,0,"High Poverty",2
"2009","West Bank and Gaza","Income share held by lowest 20%","7.7","FEBRUARY",9,0,"High Poverty",9
"2009","West Bank and Gaza","Income share held by lowest 20%","7.7","MAY",6,1,"High Poverty",7
"2009","West Bank and Gaza","Income share held by lowest 20%","7.7","APRIL",6,1,"High Poverty",7
"2009","West Bank and Gaza","Income share held by lowest 20%","7.7","MARCH",9,0,"High Poverty",9
"2009","West Bank and Gaza","Income share held by lowest 20%","7.7","OCTOBER",0,0,"High Poverty",0
"2009","West Bank and Gaza","Income share held by lowest 20%","7.7","JANUARY",978,6,"High Poverty",984
"2009","West Bank and Gaza","Income share held by lowest 20%","7.7","DECEMBER",6,1,"High Poverty",7
"2009","West Bank and Gaza","Income share held by lowest 20%","7.7","NOVEMBER",1,0,"High Poverty",1
"2009","West Bank and Gaza","Income share held by lowest 20%","7.7","AUGUST",6,0,"High Poverty",6
"2009","West Bank and Gaza","Income share held by lowest 20%","7.7","SEPTEMBER",9,0,"High Poverty",9
"2009","West Bank and Gaza","Poverty headcount ratio at $2.15 a day (2017 PPP) (% of population)","0.3","JUNE",4,0,"Low Poverty",4
"2009","West Bank and Gaza","Poverty headcount ratio at $2.15 a day (2017 PPP) (% of population)","0.3","JULY",2,0,"Low Poverty",2
"2009","West Bank and Gaza","Poverty headcount ratio at $2.15 a day (2017 PPP) (% of population)","0.3","FEBRUARY",9,0,"Low Poverty",9
"2009","West Bank and Gaza","Poverty headcount ratio at $2.15 a day (2017 PPP) (% of population)","0.3","MAY",6,1,"Low Poverty",7
"2009","West Bank and Gaza","Poverty headcount ratio at $2.15 a day (2017 PPP) (% of population)","0.3","APRIL",6,1,"Low Poverty",7
"2009","West Bank and Gaza","Poverty headcount ratio at $2.15 a day (2017 PPP) (% of population)","0.3","MARCH",9,0,"Low Poverty",9
"2009","West Bank and Gaza","Poverty headcount ratio at $2.15 a day (2017 PPP) (% of population)","0.3","OCTOBER",0,0,"Low Poverty",0
"2009","West Bank and Gaza","Poverty headcount ratio at $2.15 a day (2017 PPP) (% of population)","0.3","JANUARY",978,6,"Low Poverty",984
"2009","West Bank and Gaza","Poverty headcount ratio at $2.15 a day (2017 PPP) (% of population)","0.3","DECEMBER",6,1,"Low Poverty",7
"2009","West Bank and Gaza","Poverty headcount ratio at $2.15 a day (2017 PPP) (% of population)","0.3","NOVEMBER",1,0,"Low Poverty",1
"2009","West Bank and Gaza","Poverty headcount ratio at $2.15 a day (2017 PPP) (% of population)","0.3","AUGUST",6,0,"Low Poverty",6
"2009","West Bank and Gaza","Poverty headcount ratio at $2.15 a day (2017 PPP) (% of population)","0.3","SEPTEMBER",9,0,"Low Poverty",9
"2009","West Bank and Gaza","Income share held by highest 10%","27.4","JUNE",4,0,"High Poverty",4
"2009","West Bank and Gaza","Income share held by highest 10%","27.4","JULY",2,0,"High Poverty",2
"2009","West Bank and Gaza","Income share held by highest 10%","27.4","FEBRUARY",9,0,"High Poverty",9
"2009","West Bank and Gaza","Income share held by highest 10%","27.4","MAY",6,1,"High Poverty",7
"2009","West Bank and Gaza","Income share held by highest 10%","27.4","APRIL",6,1,"High Poverty",7
"2009","West Bank and Gaza","Income share held by highest 10%","27.4","MARCH",9,0,"High Poverty",9
"2009","West Bank and Gaza","Income share held by highest 10%","27.4","OCTOBER",0,0,"High Poverty",0
"2009","West Bank and Gaza","Income share held by highest 10%","27.4","JANUARY",978,6,"High Poverty",984
"2009","West Bank and Gaza","Income share held by highest 10%","27.4","DECEMBER",6,1,"High Poverty",7
"2009","West Bank and Gaza","Income share held by highest 10%","27.4","NOVEMBER",1,0,"High Poverty",1
"2009","West Bank and Gaza","Income share held by highest 10%","27.4","AUGUST",6,0,"High Poverty",6
"2009","West Bank and Gaza","Income share held by highest 10%","27.4","SEPTEMBER",9,0,"High Poverty",9
"2009","West Bank and Gaza","Poverty gap at $6.85 a day (2017 PPP) (%)","4.1","JUNE",4,0,"High Poverty",4
"2009","West Bank and Gaza","Poverty gap at $6.85 a day (2017 PPP) (%)","4.1","JULY",2,0,"High Poverty",2
"2009","West Bank and Gaza","Poverty gap at $6.85 a day (2017 PPP) (%)","4.1","FEBRUARY",9,0,"High Poverty",9
"2009","West Bank and Gaza","Poverty gap at $6.85 a day (2017 PPP) (%)","4.1","MAY",6,1,"High Poverty",7
"2009","West Bank and Gaza","Poverty gap at $6.85 a day (2017 PPP) (%)","4.1","APRIL",6,1,"High Poverty",7
"2009","West Bank and Gaza","Poverty gap at $6.85 a day (2017 PPP) (%)","4.1","MARCH",9,0,"High Poverty",9
"2009","West Bank and Gaza","Poverty gap at $6.85 a day (2017 PPP) (%)","4.1","OCTOBER",0,0,"High Poverty",0
"2009","West Bank and Gaza","Poverty gap at $6.85 a day (2017 PPP) (%)","4.1","JANUARY",978,6,"High Poverty",984
"2009","West Bank and Gaza","Poverty gap at $6.85 a day (2017 PPP) (%)","4.1","DECEMBER",6,1,"High Poverty",7
"2009","West Bank and Gaza","Poverty gap at $6.85 a day (2017 PPP) (%)","4.1","NOVEMBER",1,0,"High Poverty",1
"2009","West Bank and Gaza","Poverty gap at $6.85 a day (2017 PPP) (%)","4.1","AUGUST",6,0,"High Poverty",6
"2009","West Bank and Gaza","Poverty gap at $6.85 a day (2017 PPP) (%)","4.1","SEPTEMBER",9,0,"High Poverty",9
"2009","West Bank and Gaza","Poverty gap at $2.15 a day (2017 PPP) (%)","0","JUNE",4,0,"Low Poverty",4
"2009","West Bank and Gaza","Poverty gap at $2.15 a day (2017 PPP) (%)","0","JULY",2,0,"Low Poverty",2
"2009","West Bank and Gaza","Poverty gap at $2.15 a day (2017 PPP) (%)","0","FEBRUARY",9,0,"Low Poverty",9
"2009","West Bank and Gaza","Poverty gap at $2.15 a day (2017 PPP) (%)","0","MAY",6,1,"Low Poverty",7
"2009","West Bank and Gaza","Poverty gap at $2.15 a day (2017 PPP) (%)","0","APRIL",6,1,"Low Poverty",7
"2009","West Bank and Gaza","Poverty gap at $2.15 a day (2017 PPP) (%)","0","MARCH",9,0,"Low Poverty",9
"2009","West Bank and Gaza","Poverty gap at $2.15 a day (2017 PPP) (%)","0","OCTOBER",0,0,"Low Poverty",0
"2009","West Bank and Gaza","Poverty gap at $2.15 a day (2017 PPP) (%)","0","JANUARY",978,6,"Low Poverty",984
"2009","West Bank and Gaza","Poverty gap at $2.15 a day (2017 PPP) (%)","0","DECEMBER",6,1,"Low Poverty",7
"2009","West Bank and Gaza","Poverty gap at $2.15 a day (2017 PPP) (%)","0","NOVEMBER",1,0,"Low Poverty",1
"2009","West Bank and Gaza","Poverty gap at $2.15 a day (2017 PPP) (%)","0","AUGUST",6,0,"Low Poverty",6
"2009","West Bank and Gaza","Poverty gap at $2.15 a day (2017 PPP) (%)","0","SEPTEMBER",9,0,"Low Poverty",9
"2009","West Bank and Gaza","Income share held by highest 20%","42.6","JUNE",4,0,"High Poverty",4
"2009","West Bank and Gaza","Income share held by highest 20%","42.6","JULY",2,0,"High Poverty",2
"2009","West Bank and Gaza","Income share held by highest 20%","42.6","FEBRUARY",9,0,"High Poverty",9
"2009","West Bank and Gaza","Income share held by highest 20%","42.6","MAY",6,1,"High Poverty",7
"2009","West Bank and Gaza","Income share held by highest 20%","42.6","APRIL",6,1,"High Poverty",7
"2009","West Bank and Gaza","Income share held by highest 20%","42.6","MARCH",9,0,"High Poverty",9
"2009","West Bank and Gaza","Income share held by highest 20%","42.6","OCTOBER",0,0,"High Poverty",0
"2009","West Bank and Gaza","Income share held by highest 20%","42.6","JANUARY",978,6,"High Poverty",984
"2009","West Bank and Gaza","Income share held by highest 20%","42.6","DECEMBER",6,1,"High Poverty",7
"2009","West Bank and Gaza","Income share held by highest 20%","42.6","NOVEMBER",1,0,"High Poverty",1
"2009","West Bank and Gaza","Income share held by highest 20%","42.6","AUGUST",6,0,"High Poverty",6
"2009","West Bank and Gaza","Income share held by highest 20%","42.6","SEPTEMBER",9,0,"High Poverty",9
"2009","West Bank and Gaza","Income share held by lowest 10%","3.2","JUNE",4,0,"High Poverty",4
"2009","West Bank and Gaza","Income share held by lowest 10%","3.2","JULY",2,0,"High Poverty",2
"2009","West Bank and Gaza","Income share held by lowest 10%","3.2","FEBRUARY",9,0,"High Poverty",9
"2009","West Bank and Gaza","Income share held by lowest 10%","3.2","MAY",6,1,"High Poverty",7
"2009","West Bank and Gaza","Income share held by lowest 10%","3.2","APRIL",6,1,"High Poverty",7
"2009","West Bank and Gaza","Income share held by lowest 10%","3.2","MARCH",9,0,"High Poverty",9
"2009","West Bank and Gaza","Income share held by lowest 10%","3.2","OCTOBER",0,0,"High Poverty",0
"2009","West Bank and Gaza","Income share held by lowest 10%","3.2","JANUARY",978,6,"High Poverty",984
"2009","West Bank and Gaza","Income share held by lowest 10%","3.2","DECEMBER",6,1,"High Poverty",7
"2009","West Bank and Gaza","Income share held by lowest 10%","3.2","NOVEMBER",1,0,"High Poverty",1
"2009","West Bank and Gaza","Income share held by lowest 10%","3.2","AUGUST",6,0,"High Poverty",6
"2009","West Bank and Gaza","Income share held by lowest 10%","3.2","SEPTEMBER",9,0,"High Poverty",9
"2009","West Bank and Gaza","Proportion of people living below 50 percent of median income (%)","9.6","JUNE",4,0,"High Poverty",4
"2009","West Bank and Gaza","Proportion of people living below 50 percent of median income (%)","9.6","JULY",2,0,"High Poverty",2
"2009","West Bank and Gaza","Proportion of people living below 50 percent of median income (%)","9.6","FEBRUARY",9,0,"High Poverty",9
"2009","West Bank and Gaza","Proportion of people living below 50 percent of median income (%)","9.6","MAY",6,1,"High Poverty",7
"2009","West Bank and Gaza","Proportion of people living below 50 percent of median income (%)","9.6","APRIL",6,1,"High Poverty",7
"2009","West Bank and Gaza","Proportion of people living below 50 percent of median income (%)","9.6","MARCH",9,0,"High Poverty",9
"2009","West Bank and Gaza","Proportion of people living below 50 percent of median income (%)","9.6","OCTOBER",0,0,"High Poverty",0
"2009","West Bank and Gaza","Proportion of people living below 50 percent of median income (%)","9.6","JANUARY",978,6,"High Poverty",984
"2009","West Bank and Gaza","Proportion of people living below 50 percent of median income (%)","9.6","DECEMBER",6,1,"High Poverty",7
"2009","West Bank and Gaza","Proportion of people living below 50 percent of median income (%)","9.6","NOVEMBER",1,0,"High Poverty",1
"2009","West Bank and Gaza","Proportion of people living below 50 percent of median income (%)","9.6","AUGUST",6,0,"High Poverty",6
"2009","West Bank and Gaza","Proportion of people living below 50 percent of median income (%)","9.6","SEPTEMBER",9,0,"High Poverty",9
"2009","West Bank and Gaza","Poverty headcount ratio at $6.85 a day (2017 PPP) (% of population)","18.2","JUNE",4,0,"Medium Poverty",4
"2009","West Bank and Gaza","Poverty headcount ratio at $6.85 a day (2017 PPP) (% of population)","18.2","JULY",2,0,"Medium Poverty",2
"2009","West Bank and Gaza","Poverty headcount ratio at $6.85 a day (2017 PPP) (% of population)","18.2","FEBRUARY",9,0,"Medium Poverty",9
"2009","West Bank and Gaza","Poverty headcount ratio at $6.85 a day (2017 PPP) (% of population)","18.2","MAY",6,1,"Medium Poverty",7
"2009","West Bank and Gaza","Poverty headcount ratio at $6.85 a day (2017 PPP) (% of population)","18.2","APRIL",6,1,"Medium Poverty",7
"2009","West Bank and Gaza","Poverty headcount ratio at $6.85 a day (2017 PPP) (% of population)","18.2","MARCH",9,0,"Medium Poverty",9
"2009","West Bank and Gaza","Poverty headcount ratio at $6.85 a day (2017 PPP) (% of population)","18.2","OCTOBER",0,0,"Medium Poverty",0
"2009","West Bank and Gaza","Poverty headcount ratio at $6.85 a day (2017 PPP) (% of population)","18.2","JANUARY",978,6,"Medium Poverty",984
"2009","West Bank and Gaza","Poverty headcount ratio at $6.85 a day (2017 PPP) (% of population)","18.2","DECEMBER",6,1,"Medium Poverty",7
"2009","West Bank and Gaza","Poverty headcount ratio at $6.85 a day (2017 PPP) (% of population)","18.2","NOVEMBER",1,0,"Medium Poverty",1
"2009","West Bank and Gaza","Poverty headcount ratio at $6.85 a day (2017 PPP) (% of population)","18.2","AUGUST",6,0,"Medium Poverty",6
"2009","West Bank and Gaza","Poverty headcount ratio at $6.85 a day (2017 PPP) (% of population)","18.2","SEPTEMBER",9,0,"Medium Poverty",9
"2009","West Bank and Gaza","Income share held by third 20%","15.9","JUNE",4,0,"Medium Poverty",4
"2009","West Bank and Gaza","Income share held by third 20%","15.9","JULY",2,0,"Medium Poverty",2
"2009","West Bank and Gaza","Income share held by third 20%","15.9","FEBRUARY",9,0,"Medium Poverty",9
"2009","West Bank and Gaza","Income share held by third 20%","15.9","MAY",6,1,"Medium Poverty",7
"2009","West Bank and Gaza","Income share held by third 20%","15.9","APRIL",6,1,"Medium Poverty",7
"2009","West Bank and Gaza","Income share held by third 20%","15.9","MARCH",9,0,"Medium Poverty",9
"2009","West Bank and Gaza","Income share held by third 20%","15.9","OCTOBER",0,0,"Medium Poverty",0
"2009","West Bank and Gaza","Income share held by third 20%","15.9","JANUARY",978,6,"Medium Poverty",984
"2009","West Bank and Gaza","Income share held by third 20%","15.9","DECEMBER",6,1,"Medium Poverty",7
"2009","West Bank and Gaza","Income share held by third 20%","15.9","NOVEMBER",1,0,"Medium Poverty",1
"2009","West Bank and Gaza","Income share held by third 20%","15.9","AUGUST",6,0,"Medium Poverty",6
"2009","West Bank and Gaza","Income share held by third 20%","15.9","SEPTEMBER",9,0,"Medium Poverty",9
"2010","West Bank and Gaza","Income share held by third 20%","15.7","APRIL",5,0,"Medium Poverty",5
"2010","West Bank and Gaza","Income share held by third 20%","15.7","AUGUST",2,4,"Medium Poverty",6
"2010","West Bank and Gaza","Income share held by third 20%","15.7","JULY",5,0,"Medium Poverty",5
"2010","West Bank and Gaza","Income share held by third 20%","15.7","JUNE",15,1,"Medium Poverty",16
"2010","West Bank and Gaza","Income share held by third 20%","15.7","MAY",2,0,"Medium Poverty",2
"2010","West Bank and Gaza","Income share held by third 20%","15.7","MARCH",8,2,"Medium Poverty",10
"2010","West Bank and Gaza","Income share held by third 20%","15.7","FEBRUARY",2,2,"Medium Poverty",4
"2010","West Bank and Gaza","Income share held by third 20%","15.7","JANUARY",8,0,"Medium Poverty",8
"2010","West Bank and Gaza","Income share held by third 20%","15.7","OCTOBER",6,0,"Medium Poverty",6
"2010","West Bank and Gaza","Income share held by third 20%","15.7","SEPTEMBER",13,0,"Medium Poverty",13
"2010","West Bank and Gaza","Income share held by third 20%","15.7","DECEMBER",13,0,"Medium Poverty",13
"2010","West Bank and Gaza","Income share held by third 20%","15.7","NOVEMBER",3,0,"Medium Poverty",3
"2010","West Bank and Gaza","Population living in slums (% of urban population)","25.25772","APRIL",5,0,"High Poverty",5
"2010","West Bank and Gaza","Population living in slums (% of urban population)","25.25772","AUGUST",2,4,"High Poverty",6
"2010","West Bank and Gaza","Population living in slums (% of urban population)","25.25772","JULY",5,0,"High Poverty",5
"2010","West Bank and Gaza","Population living in slums (% of urban population)","25.25772","JUNE",15,1,"High Poverty",16
"2010","West Bank and Gaza","Population living in slums (% of urban population)","25.25772","MAY",2,0,"High Poverty",2
"2010","West Bank and Gaza","Population living in slums (% of urban population)","25.25772","MARCH",8,2,"High Poverty",10
"2010","West Bank and Gaza","Population living in slums (% of urban population)","25.25772","FEBRUARY",2,2,"High Poverty",4
"2010","West Bank and Gaza","Population living in slums (% of urban population)","25.25772","JANUARY",8,0,"High Poverty",8
"2010","West Bank and Gaza","Population living in slums (% of urban population)","25.25772","OCTOBER",6,0,"High Poverty",6
"2010","West Bank and Gaza","Population living in slums (% of urban population)","25.25772","SEPTEMBER",13,0,"High Poverty",13
"2010","West Bank and Gaza","Population living in slums (% of urban population)","25.25772","DECEMBER",13,0,"High Poverty",13
"2010","West Bank and Gaza","Population living in slums (% of urban population)","25.25772","NOVEMBER",3,0,"High Poverty",3
"2010","West Bank and Gaza","Income share held by lowest 20%","7.5","APRIL",5,0,"High Poverty",5
"2010","West Bank and Gaza","Income share held by lowest 20%","7.5","AUGUST",2,4,"High Poverty",6
"2010","West Bank and Gaza","Income share held by lowest 20%","7.5","JULY",5,0,"High Poverty",5
"2010","West Bank and Gaza","Income share held by lowest 20%","7.5","JUNE",15,1,"High Poverty",16
"2010","West Bank and Gaza","Income share held by lowest 20%","7.5","MAY",2,0,"High Poverty",2
"2010","West Bank and Gaza","Income share held by lowest 20%","7.5","MARCH",8,2,"High Poverty",10
"2010","West Bank and Gaza","Income share held by lowest 20%","7.5","FEBRUARY",2,2,"High Poverty",4
"2010","West Bank and Gaza","Income share held by lowest 20%","7.5","JANUARY",8,0,"High Poverty",8
"2010","West Bank and Gaza","Income share held by lowest 20%","7.5","OCTOBER",6,0,"High Poverty",6
"2010","West Bank and Gaza","Income share held by lowest 20%","7.5","SEPTEMBER",13,0,"High Poverty",13
"2010","West Bank and Gaza","Income share held by lowest 20%","7.5","DECEMBER",13,0,"High Poverty",13
"2010","West Bank and Gaza","Income share held by lowest 20%","7.5","NOVEMBER",3,0,"High Poverty",3
"2010","West Bank and Gaza","Proportion of people living below 50 percent of median income (%)","10.2","APRIL",5,0,"Medium Poverty",5
"2010","West Bank and Gaza","Proportion of people living below 50 percent of median income (%)","10.2","AUGUST",2,4,"Medium Poverty",6
"2010","West Bank and Gaza","Proportion of people living below 50 percent of median income (%)","10.2","JULY",5,0,"Medium Poverty",5
"2010","West Bank and Gaza","Proportion of people living below 50 percent of median income (%)","10.2","JUNE",15,1,"Medium Poverty",16
"2010","West Bank and Gaza","Proportion of people living below 50 percent of median income (%)","10.2","MAY",2,0,"Medium Poverty",2
"2010","West Bank and Gaza","Proportion of people living below 50 percent of median income (%)","10.2","MARCH",8,2,"Medium Poverty",10
"2010","West Bank and Gaza","Proportion of people living below 50 percent of median income (%)","10.2","FEBRUARY",2,2,"Medium Poverty",4
"2010","West Bank and Gaza","Proportion of people living below 50 percent of median income (%)","10.2","JANUARY",8,0,"Medium Poverty",8
"2010","West Bank and Gaza","Proportion of people living below 50 percent of median income (%)","10.2","OCTOBER",6,0,"Medium Poverty",6
"2010","West Bank and Gaza","Proportion of people living below 50 percent of median income (%)","10.2","SEPTEMBER",13,0,"Medium Poverty",13
"2010","West Bank and Gaza","Proportion of people living below 50 percent of median income (%)","10.2","DECEMBER",13,0,"Medium Poverty",13
"2010","West Bank and Gaza","Proportion of people living below 50 percent of median income (%)","10.2","NOVEMBER",3,0,"Medium Poverty",3
"2010","West Bank and Gaza","Poverty headcount ratio at national poverty lines (% of population)","25.7","APRIL",5,0,"High Poverty",5
"2010","West Bank and Gaza","Poverty headcount ratio at national poverty lines (% of population)","25.7","AUGUST",2,4,"High Poverty",6
"2010","West Bank and Gaza","Poverty headcount ratio at national poverty lines (% of population)","25.7","JULY",5,0,"High Poverty",5
"2010","West Bank and Gaza","Poverty headcount ratio at national poverty lines (% of population)","25.7","JUNE",15,1,"High Poverty",16
"2010","West Bank and Gaza","Poverty headcount ratio at national poverty lines (% of population)","25.7","MAY",2,0,"High Poverty",2
"2010","West Bank and Gaza","Poverty headcount ratio at national poverty lines (% of population)","25.7","MARCH",8,2,"High Poverty",10
"2010","West Bank and Gaza","Poverty headcount ratio at national poverty lines (% of population)","25.7","FEBRUARY",2,2,"High Poverty",4
"2010","West Bank and Gaza","Poverty headcount ratio at national poverty lines (% of population)","25.7","JANUARY",8,0,"High Poverty",8
"2010","West Bank and Gaza","Poverty headcount ratio at national poverty lines (% of population)","25.7","OCTOBER",6,0,"High Poverty",6
"2010","West Bank and Gaza","Poverty headcount ratio at national poverty lines (% of population)","25.7","SEPTEMBER",13,0,"High Poverty",13
"2010","West Bank and Gaza","Poverty headcount ratio at national poverty lines (% of population)","25.7","DECEMBER",13,0,"High Poverty",13
"2010","West Bank and Gaza","Poverty headcount ratio at national poverty lines (% of population)","25.7","NOVEMBER",3,0,"High Poverty",3
"2010","West Bank and Gaza","Poverty gap at $6.85 a day (2017 PPP) (%)","4.4","APRIL",5,0,"High Poverty",5
"2010","West Bank and Gaza","Poverty gap at $6.85 a day (2017 PPP) (%)","4.4","AUGUST",2,4,"High Poverty",6
"2010","West Bank and Gaza","Poverty gap at $6.85 a day (2017 PPP) (%)","4.4","JULY",5,0,"High Poverty",5
"2010","West Bank and Gaza","Poverty gap at $6.85 a day (2017 PPP) (%)","4.4","JUNE",15,1,"High Poverty",16
"2010","West Bank and Gaza","Poverty gap at $6.85 a day (2017 PPP) (%)","4.4","MAY",2,0,"High Poverty",2
"2010","West Bank and Gaza","Poverty gap at $6.85 a day (2017 PPP) (%)","4.4","MARCH",8,2,"High Poverty",10
"2010","West Bank and Gaza","Poverty gap at $6.85 a day (2017 PPP) (%)","4.4","FEBRUARY",2,2,"High Poverty",4
"2010","West Bank and Gaza","Poverty gap at $6.85 a day (2017 PPP) (%)","4.4","JANUARY",8,0,"High Poverty",8
"2010","West Bank and Gaza","Poverty gap at $6.85 a day (2017 PPP) (%)","4.4","OCTOBER",6,0,"High Poverty",6
"2010","West Bank and Gaza","Poverty gap at $6.85 a day (2017 PPP) (%)","4.4","SEPTEMBER",13,0,"High Poverty",13
"2010","West Bank and Gaza","Poverty gap at $6.85 a day (2017 PPP) (%)","4.4","DECEMBER",13,0,"High Poverty",13
"2010","West Bank and Gaza","Poverty gap at $6.85 a day (2017 PPP) (%)","4.4","NOVEMBER",3,0,"High Poverty",3
"2010","West Bank and Gaza","Income share held by second 20%","11.7","APRIL",5,0,"Medium Poverty",5
"2010","West Bank and Gaza","Income share held by second 20%","11.7","AUGUST",2,4,"Medium Poverty",6
"2010","West Bank and Gaza","Income share held by second 20%","11.7","JULY",5,0,"Medium Poverty",5
"2010","West Bank and Gaza","Income share held by second 20%","11.7","JUNE",15,1,"Medium Poverty",16
"2010","West Bank and Gaza","Income share held by second 20%","11.7","MAY",2,0,"Medium Poverty",2
"2010","West Bank and Gaza","Income share held by second 20%","11.7","MARCH",8,2,"Medium Poverty",10
"2010","West Bank and Gaza","Income share held by second 20%","11.7","FEBRUARY",2,2,"Medium Poverty",4
"2010","West Bank and Gaza","Income share held by second 20%","11.7","JANUARY",8,0,"Medium Poverty",8
"2010","West Bank and Gaza","Income share held by second 20%","11.7","OCTOBER",6,0,"Medium Poverty",6
"2010","West Bank and Gaza","Income share held by second 20%","11.7","SEPTEMBER",13,0,"Medium Poverty",13
"2010","West Bank and Gaza","Income share held by second 20%","11.7","DECEMBER",13,0,"Medium Poverty",13
"2010","West Bank and Gaza","Income share held by second 20%","11.7","NOVEMBER",3,0,"Medium Poverty",3
"2010","West Bank and Gaza","Income share held by highest 10%","27.8","APRIL",5,0,"High Poverty",5
"2010","West Bank and Gaza","Income share held by highest 10%","27.8","AUGUST",2,4,"High Poverty",6
"2010","West Bank and Gaza","Income share held by highest 10%","27.8","JULY",5,0,"High Poverty",5
"2010","West Bank and Gaza","Income share held by highest 10%","27.8","JUNE",15,1,"High Poverty",16
"2010","West Bank and Gaza","Income share held by highest 10%","27.8","MAY",2,0,"High Poverty",2
"2010","West Bank and Gaza","Income share held by highest 10%","27.8","MARCH",8,2,"High Poverty",10
"2010","West Bank and Gaza","Income share held by highest 10%","27.8","FEBRUARY",2,2,"High Poverty",4
"2010","West Bank and Gaza","Income share held by highest 10%","27.8","JANUARY",8,0,"High Poverty",8
"2010","West Bank and Gaza","Income share held by highest 10%","27.8","OCTOBER",6,0,"High Poverty",6
"2010","West Bank and Gaza","Income share held by highest 10%","27.8","SEPTEMBER",13,0,"High Poverty",13
"2010","West Bank and Gaza","Income share held by highest 10%","27.8","DECEMBER",13,0,"High Poverty",13
"2010","West Bank and Gaza","Income share held by highest 10%","27.8","NOVEMBER",3,0,"High Poverty",3
"2010","West Bank and Gaza","Income share held by fourth 20%","21.9","APRIL",5,0,"High Poverty",5
"2010","West Bank and Gaza","Income share held by fourth 20%","21.9","AUGUST",2,4,"High Poverty",6
"2010","West Bank and Gaza","Income share held by fourth 20%","21.9","JULY",5,0,"High Poverty",5
"2010","West Bank and Gaza","Income share held by fourth 20%","21.9","JUNE",15,1,"High Poverty",16
"2010","West Bank and Gaza","Income share held by fourth 20%","21.9","MAY",2,0,"High Poverty",2
"2010","West Bank and Gaza","Income share held by fourth 20%","21.9","MARCH",8,2,"High Poverty",10
"2010","West Bank and Gaza","Income share held by fourth 20%","21.9","FEBRUARY",2,2,"High Poverty",4
"2010","West Bank and Gaza","Income share held by fourth 20%","21.9","JANUARY",8,0,"High Poverty",8
"2010","West Bank and Gaza","Income share held by fourth 20%","21.9","OCTOBER",6,0,"High Poverty",6
"2010","West Bank and Gaza","Income share held by fourth 20%","21.9","SEPTEMBER",13,0,"High Poverty",13
"2010","West Bank and Gaza","Income share held by fourth 20%","21.9","DECEMBER",13,0,"High Poverty",13
"2010","West Bank and Gaza","Income share held by fourth 20%","21.9","NOVEMBER",3,0,"High Poverty",3
"2010","West Bank and Gaza","Income share held by highest 20%","43.2","APRIL",5,0,"High Poverty",5
"2010","West Bank and Gaza","Income share held by highest 20%","43.2","AUGUST",2,4,"High Poverty",6
"2010","West Bank and Gaza","Income share held by highest 20%","43.2","JULY",5,0,"High Poverty",5
"2010","West Bank and Gaza","Income share held by highest 20%","43.2","JUNE",15,1,"High Poverty",16
"2010","West Bank and Gaza","Income share held by highest 20%","43.2","MAY",2,0,"High Poverty",2
"2010","West Bank and Gaza","Income share held by highest 20%","43.2","MARCH",8,2,"High Poverty",10
"2010","West Bank and Gaza","Income share held by highest 20%","43.2","FEBRUARY",2,2,"High Poverty",4
"2010","West Bank and Gaza","Income share held by highest 20%","43.2","JANUARY",8,0,"High Poverty",8
"2010","West Bank and Gaza","Income share held by highest 20%","43.2","OCTOBER",6,0,"High Poverty",6
"2010","West Bank and Gaza","Income share held by highest 20%","43.2","SEPTEMBER",13,0,"High Poverty",13
"2010","West Bank and Gaza","Income share held by highest 20%","43.2","DECEMBER",13,0,"High Poverty",13
"2010","West Bank and Gaza","Income share held by highest 20%","43.2","NOVEMBER",3,0,"High Poverty",3
"2010","West Bank and Gaza","Poverty headcount ratio at $6.85 a day (2017 PPP) (% of population)","18.9","APRIL",5,0,"Medium Poverty",5
"2010","West Bank and Gaza","Poverty headcount ratio at $6.85 a day (2017 PPP) (% of population)","18.9","AUGUST",2,4,"Medium Poverty",6
"2010","West Bank and Gaza","Poverty headcount ratio at $6.85 a day (2017 PPP) (% of population)","18.9","JULY",5,0,"Medium Poverty",5
"2010","West Bank and Gaza","Poverty headcount ratio at $6.85 a day (2017 PPP) (% of population)","18.9","JUNE",15,1,"Medium Poverty",16
"2010","West Bank and Gaza","Poverty headcount ratio at $6.85 a day (2017 PPP) (% of population)","18.9","MAY",2,0,"Medium Poverty",2
"2010","West Bank and Gaza","Poverty headcount ratio at $6.85 a day (2017 PPP) (% of population)","18.9","MARCH",8,2,"Medium Poverty",10
"2010","West Bank and Gaza","Poverty headcount ratio at $6.85 a day (2017 PPP) (% of population)","18.9","FEBRUARY",2,2,"Medium Poverty",4
"2010","West Bank and Gaza","Poverty headcount ratio at $6.85 a day (2017 PPP) (% of population)","18.9","JANUARY",8,0,"Medium Poverty",8
"2010","West Bank and Gaza","Poverty headcount ratio at $6.85 a day (2017 PPP) (% of population)","18.9","OCTOBER",6,0,"Medium Poverty",6
"2010","West Bank and Gaza","Poverty headcount ratio at $6.85 a day (2017 PPP) (% of population)","18.9","SEPTEMBER",13,0,"Medium Poverty",13
"2010","West Bank and Gaza","Poverty headcount ratio at $6.85 a day (2017 PPP) (% of population)","18.9","DECEMBER",13,0,"Medium Poverty",13
"2010","West Bank and Gaza","Poverty headcount ratio at $6.85 a day (2017 PPP) (% of population)","18.9","NOVEMBER",3,0,"Medium Poverty",3
"2010","West Bank and Gaza","Poverty gap at $2.15 a day (2017 PPP) (%)","0","APRIL",5,0,"Low Poverty",5
"2010","West Bank and Gaza","Poverty gap at $2.15 a day (2017 PPP) (%)","0","AUGUST",2,4,"Low Poverty",6
"2010","West Bank and Gaza","Poverty gap at $2.15 a day (2017 PPP) (%)","0","JULY",5,0,"Low Poverty",5
"2010","West Bank and Gaza","Poverty gap at $2.15 a day (2017 PPP) (%)","0","JUNE",15,1,"Low Poverty",16
"2010","West Bank and Gaza","Poverty gap at $2.15 a day (2017 PPP) (%)","0","MAY",2,0,"Low Poverty",2
"2010","West Bank and Gaza","Poverty gap at $2.15 a day (2017 PPP) (%)","0","MARCH",8,2,"Low Poverty",10
"2010","West Bank and Gaza","Poverty gap at $2.15 a day (2017 PPP) (%)","0","FEBRUARY",2,2,"Low Poverty",4
"2010","West Bank and Gaza","Poverty gap at $2.15 a day (2017 PPP) (%)","0","JANUARY",8,0,"Low Poverty",8
"2010","West Bank and Gaza","Poverty gap at $2.15 a day (2017 PPP) (%)","0","OCTOBER",6,0,"Low Poverty",6
"2010","West Bank and Gaza","Poverty gap at $2.15 a day (2017 PPP) (%)","0","SEPTEMBER",13,0,"Low Poverty",13
"2010","West Bank and Gaza","Poverty gap at $2.15 a day (2017 PPP) (%)","0","DECEMBER",13,0,"Low Poverty",13
"2010","West Bank and Gaza","Poverty gap at $2.15 a day (2017 PPP) (%)","0","NOVEMBER",3,0,"Low Poverty",3
"2010","West Bank and Gaza","Poverty headcount ratio at $3.65 a day (2017 PPP) (% of population)","2","APRIL",5,0,"Medium Poverty",5
"2010","West Bank and Gaza","Poverty headcount ratio at $3.65 a day (2017 PPP) (% of population)","2","AUGUST",2,4,"Medium Poverty",6
"2010","West Bank and Gaza","Poverty headcount ratio at $3.65 a day (2017 PPP) (% of population)","2","JULY",5,0,"Medium Poverty",5
"2010","West Bank and Gaza","Poverty headcount ratio at $3.65 a day (2017 PPP) (% of population)","2","JUNE",15,1,"Medium Poverty",16
"2010","West Bank and Gaza","Poverty headcount ratio at $3.65 a day (2017 PPP) (% of population)","2","MAY",2,0,"Medium Poverty",2
"2010","West Bank and Gaza","Poverty headcount ratio at $3.65 a day (2017 PPP) (% of population)","2","MARCH",8,2,"Medium Poverty",10
"2010","West Bank and Gaza","Poverty headcount ratio at $3.65 a day (2017 PPP) (% of population)","2","FEBRUARY",2,2,"Medium Poverty",4
"2010","West Bank and Gaza","Poverty headcount ratio at $3.65 a day (2017 PPP) (% of population)","2","JANUARY",8,0,"Medium Poverty",8
"2010","West Bank and Gaza","Poverty headcount ratio at $3.65 a day (2017 PPP) (% of population)","2","OCTOBER",6,0,"Medium Poverty",6
"2010","West Bank and Gaza","Poverty headcount ratio at $3.65 a day (2017 PPP) (% of population)","2","SEPTEMBER",13,0,"Medium Poverty",13
"2010","West Bank and Gaza","Poverty headcount ratio at $3.65 a day (2017 PPP) (% of population)","2","DECEMBER",13,0,"Medium Poverty",13
"2010","West Bank and Gaza","Poverty headcount ratio at $3.65 a day (2017 PPP) (% of population)","2","NOVEMBER",3,0,"Medium Poverty",3
"2010","West Bank and Gaza","Poverty headcount ratio at $2.15 a day (2017 PPP) (% of population)","0","APRIL",5,0,"Low Poverty",5
"2010","West Bank and Gaza","Poverty headcount ratio at $2.15 a day (2017 PPP) (% of population)","0","AUGUST",2,4,"Low Poverty",6
"2010","West Bank and Gaza","Poverty headcount ratio at $2.15 a day (2017 PPP) (% of population)","0","JULY",5,0,"Low Poverty",5
"2010","West Bank and Gaza","Poverty headcount ratio at $2.15 a day (2017 PPP) (% of population)","0","JUNE",15,1,"Low Poverty",16
"2010","West Bank and Gaza","Poverty headcount ratio at $2.15 a day (2017 PPP) (% of population)","0","MAY",2,0,"Low Poverty",2
"2010","West Bank and Gaza","Poverty headcount ratio at $2.15 a day (2017 PPP) (% of population)","0","MARCH",8,2,"Low Poverty",10
"2010","West Bank and Gaza","Poverty headcount ratio at $2.15 a day (2017 PPP) (% of population)","0","FEBRUARY",2,2,"Low Poverty",4
"2010","West Bank and Gaza","Poverty headcount ratio at $2.15 a day (2017 PPP) (% of population)","0","JANUARY",8,0,"Low Poverty",8
"2010","West Bank and Gaza","Poverty headcount ratio at $2.15 a day (2017 PPP) (% of population)","0","OCTOBER",6,0,"Low Poverty",6
"2010","West Bank and Gaza","Poverty headcount ratio at $2.15 a day (2017 PPP) (% of population)","0","SEPTEMBER",13,0,"Low Poverty",13
"2010","West Bank and Gaza","Poverty headcount ratio at $2.15 a day (2017 PPP) (% of population)","0","DECEMBER",13,0,"Low Poverty",13
"2010","West Bank and Gaza","Poverty headcount ratio at $2.15 a day (2017 PPP) (% of population)","0","NOVEMBER",3,0,"Low Poverty",3
"2010","West Bank and Gaza","Gini index","35.3","APRIL",5,0,"High Poverty",5
"2010","West Bank and Gaza","Gini index","35.3","AUGUST",2,4,"High Poverty",6
"2010","West Bank and Gaza","Gini index","35.3","JULY",5,0,"High Poverty",5
"2010","West Bank and Gaza","Gini index","35.3","JUNE",15,1,"High Poverty",16
"2010","West Bank and Gaza","Gini index","35.3","MAY",2,0,"High Poverty",2
"2010","West Bank and Gaza","Gini index","35.3","MARCH",8,2,"High Poverty",10
"2010","West Bank and Gaza","Gini index","35.3","FEBRUARY",2,2,"High Poverty",4
"2010","West Bank and Gaza","Gini index","35.3","JANUARY",8,0,"High Poverty",8
"2010","West Bank and Gaza","Gini index","35.3","OCTOBER",6,0,"High Poverty",6
"2010","West Bank and Gaza","Gini index","35.3","SEPTEMBER",13,0,"High Poverty",13
"2010","West Bank and Gaza","Gini index","35.3","DECEMBER",13,0,"High Poverty",13
"2010","West Bank and Gaza","Gini index","35.3","NOVEMBER",3,0,"High Poverty",3
"2010","West Bank and Gaza","Income share held by lowest 10%","3.1","APRIL",5,0,"High Poverty",5
"2010","West Bank and Gaza","Income share held by lowest 10%","3.1","AUGUST",2,4,"High Poverty",6
"2010","West Bank and Gaza","Income share held by lowest 10%","3.1","JULY",5,0,"High Poverty",5
"2010","West Bank and Gaza","Income share held by lowest 10%","3.1","JUNE",15,1,"High Poverty",16
"2010","West Bank and Gaza","Income share held by lowest 10%","3.1","MAY",2,0,"High Poverty",2
"2010","West Bank and Gaza","Income share held by lowest 10%","3.1","MARCH",8,2,"High Poverty",10
"2010","West Bank and Gaza","Income share held by lowest 10%","3.1","FEBRUARY",2,2,"High Poverty",4
"2010","West Bank and Gaza","Income share held by lowest 10%","3.1","JANUARY",8,0,"High Poverty",8
"2010","West Bank and Gaza","Income share held by lowest 10%","3.1","OCTOBER",6,0,"High Poverty",6
"2010","West Bank and Gaza","Income share held by lowest 10%","3.1","SEPTEMBER",13,0,"High Poverty",13
"2010","West Bank and Gaza","Income share held by lowest 10%","3.1","DECEMBER",13,0,"High Poverty",13
"2010","West Bank and Gaza","Income share held by lowest 10%","3.1","NOVEMBER",3,0,"High Poverty",3
"2010","West Bank and Gaza","Poverty gap at $3.65 a day (2017 PPP) (%)","0.3","APRIL",5,0,"Low Poverty",5
"2010","West Bank and Gaza","Poverty gap at $3.65 a day (2017 PPP) (%)","0.3","AUGUST",2,4,"Low Poverty",6
"2010","West Bank and Gaza","Poverty gap at $3.65 a day (2017 PPP) (%)","0.3","JULY",5,0,"Low Poverty",5
"2010","West Bank and Gaza","Poverty gap at $3.65 a day (2017 PPP) (%)","0.3","JUNE",15,1,"Low Poverty",16
"2010","West Bank and Gaza","Poverty gap at $3.65 a day (2017 PPP) (%)","0.3","MAY",2,0,"Low Poverty",2
"2010","West Bank and Gaza","Poverty gap at $3.65 a day (2017 PPP) (%)","0.3","MARCH",8,2,"Low Poverty",10
"2010","West Bank and Gaza","Poverty gap at $3.65 a day (2017 PPP) (%)","0.3","FEBRUARY",2,2,"Low Poverty",4
"2010","West Bank and Gaza","Poverty gap at $3.65 a day (2017 PPP) (%)","0.3","JANUARY",8,0,"Low Poverty",8
"2010","West Bank and Gaza","Poverty gap at $3.65 a day (2017 PPP) (%)","0.3","OCTOBER",6,0,"Low Poverty",6
"2010","West Bank and Gaza","Poverty gap at $3.65 a day (2017 PPP) (%)","0.3","SEPTEMBER",13,0,"Low Poverty",13
"2010","West Bank and Gaza","Poverty gap at $3.65 a day (2017 PPP) (%)","0.3","DECEMBER",13,0,"Low Poverty",13
"2010","West Bank and Gaza","Poverty gap at $3.65 a day (2017 PPP) (%)","0.3","NOVEMBER",3,0,"Low Poverty",3
"2011","West Bank and Gaza","Proportion of people living below 50 percent of median income (%)","9.9","MARCH",15,5,"High Poverty",20
"2011","West Bank and Gaza","Proportion of people living below 50 percent of median income (%)","9.9","FEBRUARY",6,0,"High Poverty",6
"2011","West Bank and Gaza","Proportion of people living below 50 percent of median income (%)","9.9","JANUARY",10,0,"High Poverty",10
"2011","West Bank and Gaza","Proportion of people living below 50 percent of median income (%)","9.9","APRIL",24,2,"High Poverty",26
"2011","West Bank and Gaza","Proportion of people living below 50 percent of median income (%)","9.9","SEPTEMBER",2,2,"High Poverty",4
"2011","West Bank and Gaza","Proportion of people living below 50 percent of median income (%)","9.9","DECEMBER",8,0,"High Poverty",8
"2011","West Bank and Gaza","Proportion of people living below 50 percent of median income (%)","9.9","NOVEMBER",4,0,"High Poverty",4
"2011","West Bank and Gaza","Proportion of people living below 50 percent of median income (%)","9.9","OCTOBER",12,0,"High Poverty",12
"2011","West Bank and Gaza","Proportion of people living below 50 percent of median income (%)","9.9","MAY",2,0,"High Poverty",2
"2011","West Bank and Gaza","Proportion of people living below 50 percent of median income (%)","9.9","JUNE",0,0,"High Poverty",0
"2011","West Bank and Gaza","Proportion of people living below 50 percent of median income (%)","9.9","AUGUST",30,1,"High Poverty",31
"2011","West Bank and Gaza","Proportion of people living below 50 percent of median income (%)","9.9","JULY",4,0,"High Poverty",4
"2011","West Bank and Gaza","Survey mean consumption or income per capita, total population (2017 PPP $ per day)","14.27","MARCH",15,5,"Medium Poverty",20
"2011","West Bank and Gaza","Survey mean consumption or income per capita, total population (2017 PPP $ per day)","14.27","FEBRUARY",6,0,"Medium Poverty",6
"2011","West Bank and Gaza","Survey mean consumption or income per capita, total population (2017 PPP $ per day)","14.27","JANUARY",10,0,"Medium Poverty",10
"2011","West Bank and Gaza","Survey mean consumption or income per capita, total population (2017 PPP $ per day)","14.27","APRIL",24,2,"Medium Poverty",26
"2011","West Bank and Gaza","Survey mean consumption or income per capita, total population (2017 PPP $ per day)","14.27","SEPTEMBER",2,2,"Medium Poverty",4
"2011","West Bank and Gaza","Survey mean consumption or income per capita, total population (2017 PPP $ per day)","14.27","DECEMBER",8,0,"Medium Poverty",8
"2011","West Bank and Gaza","Survey mean consumption or income per capita, total population (2017 PPP $ per day)","14.27","NOVEMBER",4,0,"Medium Poverty",4
"2011","West Bank and Gaza","Survey mean consumption or income per capita, total population (2017 PPP $ per day)","14.27","OCTOBER",12,0,"Medium Poverty",12
"2011","West Bank and Gaza","Survey mean consumption or income per capita, total population (2017 PPP $ per day)","14.27","MAY",2,0,"Medium Poverty",2
"2011","West Bank and Gaza","Survey mean consumption or income per capita, total population (2017 PPP $ per day)","14.27","JUNE",0,0,"Medium Poverty",0
"2011","West Bank and Gaza","Survey mean consumption or income per capita, total population (2017 PPP $ per day)","14.27","AUGUST",30,1,"Medium Poverty",31
"2011","West Bank and Gaza","Survey mean consumption or income per capita, total population (2017 PPP $ per day)","14.27","JULY",4,0,"Medium Poverty",4
"2011","West Bank and Gaza","Income share held by highest 10%","27.2","MARCH",15,5,"High Poverty",20
"2011","West Bank and Gaza","Income share held by highest 10%","27.2","FEBRUARY",6,0,"High Poverty",6
"2011","West Bank and Gaza","Income share held by highest 10%","27.2","JANUARY",10,0,"High Poverty",10
"2011","West Bank and Gaza","Income share held by highest 10%","27.2","APRIL",24,2,"High Poverty",26
"2011","West Bank and Gaza","Income share held by highest 10%","27.2","SEPTEMBER",2,2,"High Poverty",4
"2011","West Bank and Gaza","Income share held by highest 10%","27.2","DECEMBER",8,0,"High Poverty",8
"2011","West Bank and Gaza","Income share held by highest 10%","27.2","NOVEMBER",4,0,"High Poverty",4
"2011","West Bank and Gaza","Income share held by highest 10%","27.2","OCTOBER",12,0,"High Poverty",12
"2011","West Bank and Gaza","Income share held by highest 10%","27.2","MAY",2,0,"High Poverty",2
"2011","West Bank and Gaza","Income share held by highest 10%","27.2","JUNE",0,0,"High Poverty",0
"2011","West Bank and Gaza","Income share held by highest 10%","27.2","AUGUST",30,1,"High Poverty",31
"2011","West Bank and Gaza","Income share held by highest 10%","27.2","JULY",4,0,"High Poverty",4
"2011","West Bank and Gaza","Income share held by lowest 20%","7.7","MARCH",15,5,"High Poverty",20
"2011","West Bank and Gaza","Income share held by lowest 20%","7.7","FEBRUARY",6,0,"High Poverty",6
"2011","West Bank and Gaza","Income share held by lowest 20%","7.7","JANUARY",10,0,"High Poverty",10
"2011","West Bank and Gaza","Income share held by lowest 20%","7.7","APRIL",24,2,"High Poverty",26
"2011","West Bank and Gaza","Income share held by lowest 20%","7.7","SEPTEMBER",2,2,"High Poverty",4
"2011","West Bank and Gaza","Income share held by lowest 20%","7.7","DECEMBER",8,0,"High Poverty",8
"2011","West Bank and Gaza","Income share held by lowest 20%","7.7","NOVEMBER",4,0,"High Poverty",4
"2011","West Bank and Gaza","Income share held by lowest 20%","7.7","OCTOBER",12,0,"High Poverty",12
"2011","West Bank and Gaza","Income share held by lowest 20%","7.7","MAY",2,0,"High Poverty",2
"2011","West Bank and Gaza","Income share held by lowest 20%","7.7","JUNE",0,0,"High Poverty",0
"2011","West Bank and Gaza","Income share held by lowest 20%","7.7","AUGUST",30,1,"High Poverty",31
"2011","West Bank and Gaza","Income share held by lowest 20%","7.7","JULY",4,0,"High Poverty",4
"2011","West Bank and Gaza","Poverty headcount ratio at national poverty lines (% of population)","25.8","MARCH",15,5,"High Poverty",20
"2011","West Bank and Gaza","Poverty headcount ratio at national poverty lines (% of population)","25.8","FEBRUARY",6,0,"High Poverty",6
"2011","West Bank and Gaza","Poverty headcount ratio at national poverty lines (% of population)","25.8","JANUARY",10,0,"High Poverty",10
"2011","West Bank and Gaza","Poverty headcount ratio at national poverty lines (% of population)","25.8","APRIL",24,2,"High Poverty",26
"2011","West Bank and Gaza","Poverty headcount ratio at national poverty lines (% of population)","25.8","SEPTEMBER",2,2,"High Poverty",4
"2011","West Bank and Gaza","Poverty headcount ratio at national poverty lines (% of population)","25.8","DECEMBER",8,0,"High Poverty",8
"2011","West Bank and Gaza","Poverty headcount ratio at national poverty lines (% of population)","25.8","NOVEMBER",4,0,"High Poverty",4
"2011","West Bank and Gaza","Poverty headcount ratio at national poverty lines (% of population)","25.8","OCTOBER",12,0,"High Poverty",12
"2011","West Bank and Gaza","Poverty headcount ratio at national poverty lines (% of population)","25.8","MAY",2,0,"High Poverty",2
"2011","West Bank and Gaza","Poverty headcount ratio at national poverty lines (% of population)","25.8","JUNE",0,0,"High Poverty",0
"2011","West Bank and Gaza","Poverty headcount ratio at national poverty lines (% of population)","25.8","AUGUST",30,1,"High Poverty",31
"2011","West Bank and Gaza","Poverty headcount ratio at national poverty lines (% of population)","25.8","JULY",4,0,"High Poverty",4
"2011","West Bank and Gaza","Poverty gap at $3.65 a day (2017 PPP) (%)","0.3","MARCH",15,5,"Low Poverty",20
"2011","West Bank and Gaza","Poverty gap at $3.65 a day (2017 PPP) (%)","0.3","FEBRUARY",6,0,"Low Poverty",6
"2011","West Bank and Gaza","Poverty gap at $3.65 a day (2017 PPP) (%)","0.3","JANUARY",10,0,"Low Poverty",10
"2011","West Bank and Gaza","Poverty gap at $3.65 a day (2017 PPP) (%)","0.3","APRIL",24,2,"Low Poverty",26
"2011","West Bank and Gaza","Poverty gap at $3.65 a day (2017 PPP) (%)","0.3","SEPTEMBER",2,2,"Low Poverty",4
"2011","West Bank and Gaza","Poverty gap at $3.65 a day (2017 PPP) (%)","0.3","DECEMBER",8,0,"Low Poverty",8
"2011","West Bank and Gaza","Poverty gap at $3.65 a day (2017 PPP) (%)","0.3","NOVEMBER",4,0,"Low Poverty",4
"2011","West Bank and Gaza","Poverty gap at $3.65 a day (2017 PPP) (%)","0.3","OCTOBER",12,0,"Low Poverty",12
"2011","West Bank and Gaza","Poverty gap at $3.65 a day (2017 PPP) (%)","0.3","MAY",2,0,"Low Poverty",2
"2011","West Bank and Gaza","Poverty gap at $3.65 a day (2017 PPP) (%)","0.3","JUNE",0,0,"Low Poverty",0
"2011","West Bank and Gaza","Poverty gap at $3.65 a day (2017 PPP) (%)","0.3","AUGUST",30,1,"Low Poverty",31
"2011","West Bank and Gaza","Poverty gap at $3.65 a day (2017 PPP) (%)","0.3","JULY",4,0,"Low Poverty",4
"2011","West Bank and Gaza","Poverty gap at $6.85 a day (2017 PPP) (%)","4.1","MARCH",15,5,"High Poverty",20
"2011","West Bank and Gaza","Poverty gap at $6.85 a day (2017 PPP) (%)","4.1","FEBRUARY",6,0,"High Poverty",6
"2011","West Bank and Gaza","Poverty gap at $6.85 a day (2017 PPP) (%)","4.1","JANUARY",10,0,"High Poverty",10
"2011","West Bank and Gaza","Poverty gap at $6.85 a day (2017 PPP) (%)","4.1","APRIL",24,2,"High Poverty",26
"2011","West Bank and Gaza","Poverty gap at $6.85 a day (2017 PPP) (%)","4.1","SEPTEMBER",2,2,"High Poverty",4
"2011","West Bank and Gaza","Poverty gap at $6.85 a day (2017 PPP) (%)","4.1","DECEMBER",8,0,"High Poverty",8
"2011","West Bank and Gaza","Poverty gap at $6.85 a day (2017 PPP) (%)","4.1","NOVEMBER",4,0,"High Poverty",4
"2011","West Bank and Gaza","Poverty gap at $6.85 a day (2017 PPP) (%)","4.1","OCTOBER",12,0,"High Poverty",12
"2011","West Bank and Gaza","Poverty gap at $6.85 a day (2017 PPP) (%)","4.1","MAY",2,0,"High Poverty",2
"2011","West Bank and Gaza","Poverty gap at $6.85 a day (2017 PPP) (%)","4.1","JUNE",0,0,"High Poverty",0
"2011","West Bank and Gaza","Poverty gap at $6.85 a day (2017 PPP) (%)","4.1","AUGUST",30,1,"High Poverty",31
"2011","West Bank and Gaza","Poverty gap at $6.85 a day (2017 PPP) (%)","4.1","JULY",4,0,"High Poverty",4
"2011","West Bank and Gaza","Poverty headcount ratio at $6.85 a day (2017 PPP) (% of population)","17.6","MARCH",15,5,"Medium Poverty",20
"2011","West Bank and Gaza","Poverty headcount ratio at $6.85 a day (2017 PPP) (% of population)","17.6","FEBRUARY",6,0,"Medium Poverty",6
"2011","West Bank and Gaza","Poverty headcount ratio at $6.85 a day (2017 PPP) (% of population)","17.6","JANUARY",10,0,"Medium Poverty",10
"2011","West Bank and Gaza","Poverty headcount ratio at $6.85 a day (2017 PPP) (% of population)","17.6","APRIL",24,2,"Medium Poverty",26
"2011","West Bank and Gaza","Poverty headcount ratio at $6.85 a day (2017 PPP) (% of population)","17.6","SEPTEMBER",2,2,"Medium Poverty",4
"2011","West Bank and Gaza","Poverty headcount ratio at $6.85 a day (2017 PPP) (% of population)","17.6","DECEMBER",8,0,"Medium Poverty",8
"2011","West Bank and Gaza","Poverty headcount ratio at $6.85 a day (2017 PPP) (% of population)","17.6","NOVEMBER",4,0,"Medium Poverty",4
"2011","West Bank and Gaza","Poverty headcount ratio at $6.85 a day (2017 PPP) (% of population)","17.6","OCTOBER",12,0,"Medium Poverty",12
"2011","West Bank and Gaza","Poverty headcount ratio at $6.85 a day (2017 PPP) (% of population)","17.6","MAY",2,0,"Medium Poverty",2
"2011","West Bank and Gaza","Poverty headcount ratio at $6.85 a day (2017 PPP) (% of population)","17.6","JUNE",0,0,"Medium Poverty",0
"2011","West Bank and Gaza","Poverty headcount ratio at $6.85 a day (2017 PPP) (% of population)","17.6","AUGUST",30,1,"Medium Poverty",31
"2011","West Bank and Gaza","Poverty headcount ratio at $6.85 a day (2017 PPP) (% of population)","17.6","JULY",4,0,"Medium Poverty",4
"2011","West Bank and Gaza","Poverty gap at $2.15 a day (2017 PPP) (%)","0.1","MARCH",15,5,"Low Poverty",20
"2011","West Bank and Gaza","Poverty gap at $2.15 a day (2017 PPP) (%)","0.1","FEBRUARY",6,0,"Low Poverty",6
"2011","West Bank and Gaza","Poverty gap at $2.15 a day (2017 PPP) (%)","0.1","JANUARY",10,0,"Low Poverty",10
"2011","West Bank and Gaza","Poverty gap at $2.15 a day (2017 PPP) (%)","0.1","APRIL",24,2,"Low Poverty",26
"2011","West Bank and Gaza","Poverty gap at $2.15 a day (2017 PPP) (%)","0.1","SEPTEMBER",2,2,"Low Poverty",4
"2011","West Bank and Gaza","Poverty gap at $2.15 a day (2017 PPP) (%)","0.1","DECEMBER",8,0,"Low Poverty",8
"2011","West Bank and Gaza","Poverty gap at $2.15 a day (2017 PPP) (%)","0.1","NOVEMBER",4,0,"Low Poverty",4
"2011","West Bank and Gaza","Poverty gap at $2.15 a day (2017 PPP) (%)","0.1","OCTOBER",12,0,"Low Poverty",12
"2011","West Bank and Gaza","Poverty gap at $2.15 a day (2017 PPP) (%)","0.1","MAY",2,0,"Low Poverty",2
"2011","West Bank and Gaza","Poverty gap at $2.15 a day (2017 PPP) (%)","0.1","JUNE",0,0,"Low Poverty",0
"2011","West Bank and Gaza","Poverty gap at $2.15 a day (2017 PPP) (%)","0.1","AUGUST",30,1,"Low Poverty",31
"2011","West Bank and Gaza","Poverty gap at $2.15 a day (2017 PPP) (%)","0.1","JULY",4,0,"Low Poverty",4
"2011","West Bank and Gaza","Poverty headcount ratio at $2.15 a day (2017 PPP) (% of population)","0.2","MARCH",15,5,"Low Poverty",20
"2011","West Bank and Gaza","Poverty headcount ratio at $2.15 a day (2017 PPP) (% of population)","0.2","FEBRUARY",6,0,"Low Poverty",6
"2011","West Bank and Gaza","Poverty headcount ratio at $2.15 a day (2017 PPP) (% of population)","0.2","JANUARY",10,0,"Low Poverty",10
"2011","West Bank and Gaza","Poverty headcount ratio at $2.15 a day (2017 PPP) (% of population)","0.2","APRIL",24,2,"Low Poverty",26
"2011","West Bank and Gaza","Poverty headcount ratio at $2.15 a day (2017 PPP) (% of population)","0.2","SEPTEMBER",2,2,"Low Poverty",4
"2011","West Bank and Gaza","Poverty headcount ratio at $2.15 a day (2017 PPP) (% of population)","0.2","DECEMBER",8,0,"Low Poverty",8
"2011","West Bank and Gaza","Poverty headcount ratio at $2.15 a day (2017 PPP) (% of population)","0.2","NOVEMBER",4,0,"Low Poverty",4
"2011","West Bank and Gaza","Poverty headcount ratio at $2.15 a day (2017 PPP) (% of population)","0.2","OCTOBER",12,0,"Low Poverty",12
"2011","West Bank and Gaza","Poverty headcount ratio at $2.15 a day (2017 PPP) (% of population)","0.2","MAY",2,0,"Low Poverty",2
"2011","West Bank and Gaza","Poverty headcount ratio at $2.15 a day (2017 PPP) (% of population)","0.2","JUNE",0,0,"Low Poverty",0
"2011","West Bank and Gaza","Poverty headcount ratio at $2.15 a day (2017 PPP) (% of population)","0.2","AUGUST",30,1,"Low Poverty",31
"2011","West Bank and Gaza","Poverty headcount ratio at $2.15 a day (2017 PPP) (% of population)","0.2","JULY",4,0,"Low Poverty",4
"2011","West Bank and Gaza","Income share held by lowest 10%","3.1","MARCH",15,5,"High Poverty",20
"2011","West Bank and Gaza","Income share held by lowest 10%","3.1","FEBRUARY",6,0,"High Poverty",6
"2011","West Bank and Gaza","Income share held by lowest 10%","3.1","JANUARY",10,0,"High Poverty",10
"2011","West Bank and Gaza","Income share held by lowest 10%","3.1","APRIL",24,2,"High Poverty",26
"2011","West Bank and Gaza","Income share held by lowest 10%","3.1","SEPTEMBER",2,2,"High Poverty",4
"2011","West Bank and Gaza","Income share held by lowest 10%","3.1","DECEMBER",8,0,"High Poverty",8
"2011","West Bank and Gaza","Income share held by lowest 10%","3.1","NOVEMBER",4,0,"High Poverty",4
"2011","West Bank and Gaza","Income share held by lowest 10%","3.1","OCTOBER",12,0,"High Poverty",12
"2011","West Bank and Gaza","Income share held by lowest 10%","3.1","MAY",2,0,"High Poverty",2
"2011","West Bank and Gaza","Income share held by lowest 10%","3.1","JUNE",0,0,"High Poverty",0
"2011","West Bank and Gaza","Income share held by lowest 10%","3.1","AUGUST",30,1,"High Poverty",31
"2011","West Bank and Gaza","Income share held by lowest 10%","3.1","JULY",4,0,"High Poverty",4
"2011","West Bank and Gaza","Survey mean consumption or income per capita, bottom 40% of population (2017 PPP $ per day)","6.98","MARCH",15,5,"High Poverty",20
"2011","West Bank and Gaza","Survey mean consumption or income per capita, bottom 40% of population (2017 PPP $ per day)","6.98","FEBRUARY",6,0,"High Poverty",6
"2011","West Bank and Gaza","Survey mean consumption or income per capita, bottom 40% of population (2017 PPP $ per day)","6.98","JANUARY",10,0,"High Poverty",10
"2011","West Bank and Gaza","Survey mean consumption or income per capita, bottom 40% of population (2017 PPP $ per day)","6.98","APRIL",24,2,"High Poverty",26
"2011","West Bank and Gaza","Survey mean consumption or income per capita, bottom 40% of population (2017 PPP $ per day)","6.98","SEPTEMBER",2,2,"High Poverty",4
"2011","West Bank and Gaza","Survey mean consumption or income per capita, bottom 40% of population (2017 PPP $ per day)","6.98","DECEMBER",8,0,"High Poverty",8
"2011","West Bank and Gaza","Survey mean consumption or income per capita, bottom 40% of population (2017 PPP $ per day)","6.98","NOVEMBER",4,0,"High Poverty",4
"2011","West Bank and Gaza","Survey mean consumption or income per capita, bottom 40% of population (2017 PPP $ per day)","6.98","OCTOBER",12,0,"High Poverty",12
"2011","West Bank and Gaza","Survey mean consumption or income per capita, bottom 40% of population (2017 PPP $ per day)","6.98","MAY",2,0,"High Poverty",2
"2011","West Bank and Gaza","Survey mean consumption or income per capita, bottom 40% of population (2017 PPP $ per day)","6.98","JUNE",0,0,"High Poverty",0
"2011","West Bank and Gaza","Survey mean consumption or income per capita, bottom 40% of population (2017 PPP $ per day)","6.98","AUGUST",30,1,"High Poverty",31
"2011","West Bank and Gaza","Survey mean consumption or income per capita, bottom 40% of population (2017 PPP $ per day)","6.98","JULY",4,0,"High Poverty",4
"2011","West Bank and Gaza","Income share held by highest 20%","42.5","MARCH",15,5,"High Poverty",20
"2011","West Bank and Gaza","Income share held by highest 20%","42.5","FEBRUARY",6,0,"High Poverty",6
"2011","West Bank and Gaza","Income share held by highest 20%","42.5","JANUARY",10,0,"High Poverty",10
"2011","West Bank and Gaza","Income share held by highest 20%","42.5","APRIL",24,2,"High Poverty",26
"2011","West Bank and Gaza","Income share held by highest 20%","42.5","SEPTEMBER",2,2,"High Poverty",4
"2011","West Bank and Gaza","Income share held by highest 20%","42.5","DECEMBER",8,0,"High Poverty",8
"2011","West Bank and Gaza","Income share held by highest 20%","42.5","NOVEMBER",4,0,"High Poverty",4
"2011","West Bank and Gaza","Income share held by highest 20%","42.5","OCTOBER",12,0,"High Poverty",12
"2011","West Bank and Gaza","Income share held by highest 20%","42.5","MAY",2,0,"High Poverty",2
"2011","West Bank and Gaza","Income share held by highest 20%","42.5","JUNE",0,0,"High Poverty",0
"2011","West Bank and Gaza","Income share held by highest 20%","42.5","AUGUST",30,1,"High Poverty",31
"2011","West Bank and Gaza","Income share held by highest 20%","42.5","JULY",4,0,"High Poverty",4
"2011","West Bank and Gaza","Gini index","34.4","MARCH",15,5,"High Poverty",20
"2011","West Bank and Gaza","Gini index","34.4","FEBRUARY",6,0,"High Poverty",6
"2011","West Bank and Gaza","Gini index","34.4","JANUARY",10,0,"High Poverty",10
"2011","West Bank and Gaza","Gini index","34.4","APRIL",24,2,"High Poverty",26
"2011","West Bank and Gaza","Gini index","34.4","SEPTEMBER",2,2,"High Poverty",4
"2011","West Bank and Gaza","Gini index","34.4","DECEMBER",8,0,"High Poverty",8
"2011","West Bank and Gaza","Gini index","34.4","NOVEMBER",4,0,"High Poverty",4
"2011","West Bank and Gaza","Gini index","34.4","OCTOBER",12,0,"High Poverty",12
"2011","West Bank and Gaza","Gini index","34.4","MAY",2,0,"High Poverty",2
"2011","West Bank and Gaza","Gini index","34.4","JUNE",0,0,"High Poverty",0
"2011","West Bank and Gaza","Gini index","34.4","AUGUST",30,1,"High Poverty",31
"2011","West Bank and Gaza","Gini index","34.4","JULY",4,0,"High Poverty",4
"2011","West Bank and Gaza","Income share held by third 20%","15.9","MARCH",15,5,"Medium Poverty",20
"2011","West Bank and Gaza","Income share held by third 20%","15.9","FEBRUARY",6,0,"Medium Poverty",6
"2011","West Bank and Gaza","Income share held by third 20%","15.9","JANUARY",10,0,"Medium Poverty",10
"2011","West Bank and Gaza","Income share held by third 20%","15.9","APRIL",24,2,"Medium Poverty",26
"2011","West Bank and Gaza","Income share held by third 20%","15.9","SEPTEMBER",2,2,"Medium Poverty",4
"2011","West Bank and Gaza","Income share held by third 20%","15.9","DECEMBER",8,0,"Medium Poverty",8
"2011","West Bank and Gaza","Income share held by third 20%","15.9","NOVEMBER",4,0,"Medium Poverty",4
"2011","West Bank and Gaza","Income share held by third 20%","15.9","OCTOBER",12,0,"Medium Poverty",12
"2011","West Bank and Gaza","Income share held by third 20%","15.9","MAY",2,0,"Medium Poverty",2
"2011","West Bank and Gaza","Income share held by third 20%","15.9","JUNE",0,0,"Medium Poverty",0
"2011","West Bank and Gaza","Income share held by third 20%","15.9","AUGUST",30,1,"Medium Poverty",31
"2011","West Bank and Gaza","Income share held by third 20%","15.9","JULY",4,0,"Medium Poverty",4
"2011","West Bank and Gaza","Income share held by second 20%","11.9","MARCH",15,5,"Medium Poverty",20
"2011","West Bank and Gaza","Income share held by second 20%","11.9","FEBRUARY",6,0,"Medium Poverty",6
"2011","West Bank and Gaza","Income share held by second 20%","11.9","JANUARY",10,0,"Medium Poverty",10
"2011","West Bank and Gaza","Income share held by second 20%","11.9","APRIL",24,2,"Medium Poverty",26
"2011","West Bank and Gaza","Income share held by second 20%","11.9","SEPTEMBER",2,2,"Medium Poverty",4
"2011","West Bank and Gaza","Income share held by second 20%","11.9","DECEMBER",8,0,"Medium Poverty",8
"2011","West Bank and Gaza","Income share held by second 20%","11.9","NOVEMBER",4,0,"Medium Poverty",4
"2011","West Bank and Gaza","Income share held by second 20%","11.9","OCTOBER",12,0,"Medium Poverty",12
"2011","West Bank and Gaza","Income share held by second 20%","11.9","MAY",2,0,"Medium Poverty",2
"2011","West Bank and Gaza","Income share held by second 20%","11.9","JUNE",0,0,"Medium Poverty",0
"2011","West Bank and Gaza","Income share held by second 20%","11.9","AUGUST",30,1,"Medium Poverty",31
"2011","West Bank and Gaza","Income share held by second 20%","11.9","JULY",4,0,"Medium Poverty",4
"2011","West Bank and Gaza","Income share held by fourth 20%","22","MARCH",15,5,"High Poverty",20
"2011","West Bank and Gaza","Income share held by fourth 20%","22","FEBRUARY",6,0,"High Poverty",6
"2011","West Bank and Gaza","Income share held by fourth 20%","22","JANUARY",10,0,"High Poverty",10
"2011","West Bank and Gaza","Income share held by fourth 20%","22","APRIL",24,2,"High Poverty",26
"2011","West Bank and Gaza","Income share held by fourth 20%","22","SEPTEMBER",2,2,"High Poverty",4
"2011","West Bank and Gaza","Income share held by fourth 20%","22","DECEMBER",8,0,"High Poverty",8
"2011","West Bank and Gaza","Income share held by fourth 20%","22","NOVEMBER",4,0,"High Poverty",4
"2011","West Bank and Gaza","Income share held by fourth 20%","22","OCTOBER",12,0,"High Poverty",12
"2011","West Bank and Gaza","Income share held by fourth 20%","22","MAY",2,0,"High Poverty",2
"2011","West Bank and Gaza","Income share held by fourth 20%","22","JUNE",0,0,"High Poverty",0
"2011","West Bank and Gaza","Income share held by fourth 20%","22","AUGUST",30,1,"High Poverty",31
"2011","West Bank and Gaza","Income share held by fourth 20%","22","JULY",4,0,"High Poverty",4
"2011","West Bank and Gaza","Poverty headcount ratio at $3.65 a day (2017 PPP) (% of population)","1.8","MARCH",15,5,"Low Poverty",20
"2011","West Bank and Gaza","Poverty headcount ratio at $3.65 a day (2017 PPP) (% of population)","1.8","FEBRUARY",6,0,"Low Poverty",6
"2011","West Bank and Gaza","Poverty headcount ratio at $3.65 a day (2017 PPP) (% of population)","1.8","JANUARY",10,0,"Low Poverty",10
"2011","West Bank and Gaza","Poverty headcount ratio at $3.65 a day (2017 PPP) (% of population)","1.8","APRIL",24,2,"Low Poverty",26
"2011","West Bank and Gaza","Poverty headcount ratio at $3.65 a day (2017 PPP) (% of population)","1.8","SEPTEMBER",2,2,"Low Poverty",4
"2011","West Bank and Gaza","Poverty headcount ratio at $3.65 a day (2017 PPP) (% of population)","1.8","DECEMBER",8,0,"Low Poverty",8
"2011","West Bank and Gaza","Poverty headcount ratio at $3.65 a day (2017 PPP) (% of population)","1.8","NOVEMBER",4,0,"Low Poverty",4
"2011","West Bank and Gaza","Poverty headcount ratio at $3.65 a day (2017 PPP) (% of population)","1.8","OCTOBER",12,0,"Low Poverty",12
"2011","West Bank and Gaza","Poverty headcount ratio at $3.65 a day (2017 PPP) (% of population)","1.8","MAY",2,0,"Low Poverty",2
"2011","West Bank and Gaza","Poverty headcount ratio at $3.65 a day (2017 PPP) (% of population)","1.8","JUNE",0,0,"Low Poverty",0
"2011","West Bank and Gaza","Poverty headcount ratio at $3.65 a day (2017 PPP) (% of population)","1.8","AUGUST",30,1,"Low Poverty",31
"2011","West Bank and Gaza","Poverty headcount ratio at $3.65 a day (2017 PPP) (% of population)","1.8","JULY",4,0,"Low Poverty",4
"2012","West Bank and Gaza","Population living in slums (% of urban population)","23.35102","MARCH",28,0,"High Poverty",28
"2012","West Bank and Gaza","Population living in slums (% of urban population)","23.35102","FEBRUARY",2,0,"High Poverty",2
"2012","West Bank and Gaza","Population living in slums (% of urban population)","23.35102","JANUARY",2,0,"High Poverty",2
"2012","West Bank and Gaza","Population living in slums (% of urban population)","23.35102","SEPTEMBER",8,0,"High Poverty",8
"2012","West Bank and Gaza","Population living in slums (% of urban population)","23.35102","DECEMBER",2,0,"High Poverty",2
"2012","West Bank and Gaza","Population living in slums (% of urban population)","23.35102","NOVEMBER",181,6,"High Poverty",187
"2012","West Bank and Gaza","Population living in slums (% of urban population)","23.35102","OCTOBER",12,0,"High Poverty",12
"2012","West Bank and Gaza","Population living in slums (% of urban population)","23.35102","MAY",0,0,"High Poverty",0
"2012","West Bank and Gaza","Population living in slums (% of urban population)","23.35102","AUGUST",1,0,"High Poverty",1
"2012","West Bank and Gaza","Population living in slums (% of urban population)","23.35102","JULY",3,0,"High Poverty",3
"2012","West Bank and Gaza","Population living in slums (% of urban population)","23.35102","JUNE",15,1,"High Poverty",16
"2012","West Bank and Gaza","Population living in slums (% of urban population)","23.35102","APRIL",1,0,"High Poverty",1
"2014","West Bank and Gaza","Population living in slums (% of urban population)","21.44433","JANUARY",6,0,"High Poverty",6
"2014","West Bank and Gaza","Population living in slums (% of urban population)","21.44433","DECEMBER",5,0,"High Poverty",5
"2014","West Bank and Gaza","Population living in slums (% of urban population)","21.44433","NOVEMBER",8,10,"High Poverty",18
"2014","West Bank and Gaza","Population living in slums (% of urban population)","21.44433","OCTOBER",8,2,"High Poverty",10
"2014","West Bank and Gaza","Population living in slums (% of urban population)","21.44433","SEPTEMBER",20,0,"High Poverty",20
"2014","West Bank and Gaza","Population living in slums (% of urban population)","21.44433","AUGUST",614,9,"High Poverty",623
"2014","West Bank and Gaza","Population living in slums (% of urban population)","21.44433","JULY",1590,59,"High Poverty",1649
"2014","West Bank and Gaza","Population living in slums (% of urban population)","21.44433","JUNE",10,3,"High Poverty",13
"2014","West Bank and Gaza","Population living in slums (% of urban population)","21.44433","MAY",3,1,"High Poverty",4
"2014","West Bank and Gaza","Population living in slums (% of urban population)","21.44433","APRIL",0,1,"High Poverty",1
"2014","West Bank and Gaza","Population living in slums (% of urban population)","21.44433","MARCH",12,0,"High Poverty",12
"2014","West Bank and Gaza","Population living in slums (% of urban population)","21.44433","FEBRUARY",3,0,"High Poverty",3
"2016","West Bank and Gaza","Population living in slums (% of urban population)","19.53763","DECEMBER",5,0,"Medium Poverty",5
"2016","West Bank and Gaza","Population living in slums (% of urban population)","19.53763","NOVEMBER",6,0,"Medium Poverty",6
"2016","West Bank and Gaza","Population living in slums (% of urban population)","19.53763","AUGUST",3,0,"Medium Poverty",3
"2016","West Bank and Gaza","Population living in slums (% of urban population)","19.53763","JULY",9,1,"Medium Poverty",10
"2016","West Bank and Gaza","Population living in slums (% of urban population)","19.53763","JUNE",7,5,"Medium Poverty",12
"2016","West Bank and Gaza","Population living in slums (% of urban population)","19.53763","MAY",3,0,"Medium Poverty",3
"2016","West Bank and Gaza","Population living in slums (% of urban population)","19.53763","APRIL",3,0,"Medium Poverty",3
"2016","West Bank and Gaza","Population living in slums (% of urban population)","19.53763","MARCH",23,0,"Medium Poverty",23
"2016","West Bank and Gaza","Population living in slums (% of urban population)","19.53763","FEBRUARY",17,2,"Medium Poverty",19
"2016","West Bank and Gaza","Population living in slums (% of urban population)","19.53763","JANUARY",20,2,"Medium Poverty",22
"2016","West Bank and Gaza","Population living in slums (% of urban population)","19.53763","OCTOBER",8,2,"Medium Poverty",10
"2016","West Bank and Gaza","Population living in slums (% of urban population)","19.53763","SEPTEMBER",11,0,"Medium Poverty",11
"2016","West Bank and Gaza","Income share held by highest 10%","25.2","DECEMBER",5,0,"High Poverty",5
"2016","West Bank and Gaza","Income share held by highest 10%","25.2","NOVEMBER",6,0,"High Poverty",6
"2016","West Bank and Gaza","Income share held by highest 10%","25.2","AUGUST",3,0,"High Poverty",3
"2016","West Bank and Gaza","Income share held by highest 10%","25.2","JULY",9,1,"High Poverty",10
"2016","West Bank and Gaza","Income share held by highest 10%","25.2","JUNE",7,5,"High Poverty",12
"2016","West Bank and Gaza","Income share held by highest 10%","25.2","MAY",3,0,"High Poverty",3
"2016","West Bank and Gaza","Income share held by highest 10%","25.2","APRIL",3,0,"High Poverty",3
"2016","West Bank and Gaza","Income share held by highest 10%","25.2","MARCH",23,0,"High Poverty",23
"2016","West Bank and Gaza","Income share held by highest 10%","25.2","FEBRUARY",17,2,"High Poverty",19
"2016","West Bank and Gaza","Income share held by highest 10%","25.2","JANUARY",20,2,"High Poverty",22
"2016","West Bank and Gaza","Income share held by highest 10%","25.2","OCTOBER",8,2,"High Poverty",10
"2016","West Bank and Gaza","Income share held by highest 10%","25.2","SEPTEMBER",11,0,"High Poverty",11
"2016","West Bank and Gaza","Survey mean consumption or income per capita, bottom 40% of population (2017 PPP $ per day)","6.63","DECEMBER",5,0,"High Poverty",5
"2016","West Bank and Gaza","Survey mean consumption or income per capita, bottom 40% of population (2017 PPP $ per day)","6.63","NOVEMBER",6,0,"High Poverty",6
"2016","West Bank and Gaza","Survey mean consumption or income per capita, bottom 40% of population (2017 PPP $ per day)","6.63","AUGUST",3,0,"High Poverty",3
"2016","West Bank and Gaza","Survey mean consumption or income per capita, bottom 40% of population (2017 PPP $ per day)","6.63","JULY",9,1,"High Poverty",10
"2016","West Bank and Gaza","Survey mean consumption or income per capita, bottom 40% of population (2017 PPP $ per day)","6.63","JUNE",7,5,"High Poverty",12
"2016","West Bank and Gaza","Survey mean consumption or income per capita, bottom 40% of population (2017 PPP $ per day)","6.63","MAY",3,0,"High Poverty",3
"2016","West Bank and Gaza","Survey mean consumption or income per capita, bottom 40% of population (2017 PPP $ per day)","6.63","APRIL",3,0,"High Poverty",3
"2016","West Bank and Gaza","Survey mean consumption or income per capita, bottom 40% of population (2017 PPP $ per day)","6.63","MARCH",23,0,"High Poverty",23
"2016","West Bank and Gaza","Survey mean consumption or income per capita, bottom 40% of population (2017 PPP $ per day)","6.63","FEBRUARY",17,2,"High Poverty",19
"2016","West Bank and Gaza","Survey mean consumption or income per capita, bottom 40% of population (2017 PPP $ per day)","6.63","JANUARY",20,2,"High Poverty",22
"2016","West Bank and Gaza","Survey mean consumption or income per capita, bottom 40% of population (2017 PPP $ per day)","6.63","OCTOBER",8,2,"High Poverty",10
"2016","West Bank and Gaza","Survey mean consumption or income per capita, bottom 40% of population (2017 PPP $ per day)","6.63","SEPTEMBER",11,0,"High Poverty",11
"2016","West Bank and Gaza","Income share held by third 20%","16.6","DECEMBER",5,0,"Medium Poverty",5
"2016","West Bank and Gaza","Income share held by third 20%","16.6","NOVEMBER",6,0,"Medium Poverty",6
"2016","West Bank and Gaza","Income share held by third 20%","16.6","AUGUST",3,0,"Medium Poverty",3
"2016","West Bank and Gaza","Income share held by third 20%","16.6","JULY",9,1,"Medium Poverty",10
"2016","West Bank and Gaza","Income share held by third 20%","16.6","JUNE",7,5,"Medium Poverty",12
"2016","West Bank and Gaza","Income share held by third 20%","16.6","MAY",3,0,"Medium Poverty",3
"2016","West Bank and Gaza","Income share held by third 20%","16.6","APRIL",3,0,"Medium Poverty",3
"2016","West Bank and Gaza","Income share held by third 20%","16.6","MARCH",23,0,"Medium Poverty",23
"2016","West Bank and Gaza","Income share held by third 20%","16.6","FEBRUARY",17,2,"Medium Poverty",19
"2016","West Bank and Gaza","Income share held by third 20%","16.6","JANUARY",20,2,"Medium Poverty",22
"2016","West Bank and Gaza","Income share held by third 20%","16.6","OCTOBER",8,2,"Medium Poverty",10
"2016","West Bank and Gaza","Income share held by third 20%","16.6","SEPTEMBER",11,0,"Medium Poverty",11
"2016","West Bank and Gaza","Annualized average growth rate in per capita real survey mean consumption or income, bottom 40% of population (%)","-0.89","DECEMBER",5,0,"Low Poverty",5
"2016","West Bank and Gaza","Annualized average growth rate in per capita real survey mean consumption or income, bottom 40% of population (%)","-0.89","NOVEMBER",6,0,"Low Poverty",6
"2016","West Bank and Gaza","Annualized average growth rate in per capita real survey mean consumption or income, bottom 40% of population (%)","-0.89","AUGUST",3,0,"Low Poverty",3
"2016","West Bank and Gaza","Annualized average growth rate in per capita real survey mean consumption or income, bottom 40% of population (%)","-0.89","JULY",9,1,"Low Poverty",10
"2016","West Bank and Gaza","Annualized average growth rate in per capita real survey mean consumption or income, bottom 40% of population (%)","-0.89","JUNE",7,5,"Low Poverty",12
"2016","West Bank and Gaza","Annualized average growth rate in per capita real survey mean consumption or income, bottom 40% of population (%)","-0.89","MAY",3,0,"Low Poverty",3
"2016","West Bank and Gaza","Annualized average growth rate in per capita real survey mean consumption or income, bottom 40% of population (%)","-0.89","APRIL",3,0,"Low Poverty",3
"2016","West Bank and Gaza","Annualized average growth rate in per capita real survey mean consumption or income, bottom 40% of population (%)","-0.89","MARCH",23,0,"Low Poverty",23
"2016","West Bank and Gaza","Annualized average growth rate in per capita real survey mean consumption or income, bottom 40% of population (%)","-0.89","FEBRUARY",17,2,"Low Poverty",19
"2016","West Bank and Gaza","Annualized average growth rate in per capita real survey mean consumption or income, bottom 40% of population (%)","-0.89","JANUARY",20,2,"Low Poverty",22
"2016","West Bank and Gaza","Annualized average growth rate in per capita real survey mean consumption or income, bottom 40% of population (%)","-0.89","OCTOBER",8,2,"Low Poverty",10
"2016","West Bank and Gaza","Annualized average growth rate in per capita real survey mean consumption or income, bottom 40% of population (%)","-0.89","SEPTEMBER",11,0,"Low Poverty",11
"2016","West Bank and Gaza","Survey mean consumption or income per capita, total population (2017 PPP $ per day)","13.83","DECEMBER",5,0,"Medium Poverty",5
"2016","West Bank and Gaza","Survey mean consumption or income per capita, total population (2017 PPP $ per day)","13.83","NOVEMBER",6,0,"Medium Poverty",6
"2016","West Bank and Gaza","Survey mean consumption or income per capita, total population (2017 PPP $ per day)","13.83","AUGUST",3,0,"Medium Poverty",3
"2016","West Bank and Gaza","Survey mean consumption or income per capita, total population (2017 PPP $ per day)","13.83","JULY",9,1,"Medium Poverty",10
"2016","West Bank and Gaza","Survey mean consumption or income per capita, total population (2017 PPP $ per day)","13.83","JUNE",7,5,"Medium Poverty",12
"2016","West Bank and Gaza","Survey mean consumption or income per capita, total population (2017 PPP $ per day)","13.83","MAY",3,0,"Medium Poverty",3
"2016","West Bank and Gaza","Survey mean consumption or income per capita, total population (2017 PPP $ per day)","13.83","APRIL",3,0,"Medium Poverty",3
"2016","West Bank and Gaza","Survey mean consumption or income per capita, total population (2017 PPP $ per day)","13.83","MARCH",23,0,"Medium Poverty",23
"2016","West Bank and Gaza","Survey mean consumption or income per capita, total population (2017 PPP $ per day)","13.83","FEBRUARY",17,2,"Medium Poverty",19
"2016","West Bank and Gaza","Survey mean consumption or income per capita, total population (2017 PPP $ per day)","13.83","JANUARY",20,2,"Medium Poverty",22
"2016","West Bank and Gaza","Survey mean consumption or income per capita, total population (2017 PPP $ per day)","13.83","OCTOBER",8,2,"Medium Poverty",10
"2016","West Bank and Gaza","Survey mean consumption or income per capita, total population (2017 PPP $ per day)","13.83","SEPTEMBER",11,0,"Medium Poverty",11
"2016","West Bank and Gaza","Income share held by highest 20%","41.1","DECEMBER",5,0,"High Poverty",5
"2016","West Bank and Gaza","Income share held by highest 20%","41.1","NOVEMBER",6,0,"High Poverty",6
"2016","West Bank and Gaza","Income share held by highest 20%","41.1","AUGUST",3,0,"High Poverty",3
"2016","West Bank and Gaza","Income share held by highest 20%","41.1","JULY",9,1,"High Poverty",10
"2016","West Bank and Gaza","Income share held by highest 20%","41.1","JUNE",7,5,"High Poverty",12
"2016","West Bank and Gaza","Income share held by highest 20%","41.1","MAY",3,0,"High Poverty",3
"2016","West Bank and Gaza","Income share held by highest 20%","41.1","APRIL",3,0,"High Poverty",3
"2016","West Bank and Gaza","Income share held by highest 20%","41.1","MARCH",23,0,"High Poverty",23
"2016","West Bank and Gaza","Income share held by highest 20%","41.1","FEBRUARY",17,2,"High Poverty",19
"2016","West Bank and Gaza","Income share held by highest 20%","41.1","JANUARY",20,2,"High Poverty",22
"2016","West Bank and Gaza","Income share held by highest 20%","41.1","OCTOBER",8,2,"High Poverty",10
"2016","West Bank and Gaza","Income share held by highest 20%","41.1","SEPTEMBER",11,0,"High Poverty",11
"2016","West Bank and Gaza","Poverty gap at $6.85 a day (2017 PPP) (%)","5.3","DECEMBER",5,0,"High Poverty",5
"2016","West Bank and Gaza","Poverty gap at $6.85 a day (2017 PPP) (%)","5.3","NOVEMBER",6,0,"High Poverty",6
"2016","West Bank and Gaza","Poverty gap at $6.85 a day (2017 PPP) (%)","5.3","AUGUST",3,0,"High Poverty",3
"2016","West Bank and Gaza","Poverty gap at $6.85 a day (2017 PPP) (%)","5.3","JULY",9,1,"High Poverty",10
"2016","West Bank and Gaza","Poverty gap at $6.85 a day (2017 PPP) (%)","5.3","JUNE",7,5,"High Poverty",12
"2016","West Bank and Gaza","Poverty gap at $6.85 a day (2017 PPP) (%)","5.3","MAY",3,0,"High Poverty",3
"2016","West Bank and Gaza","Poverty gap at $6.85 a day (2017 PPP) (%)","5.3","APRIL",3,0,"High Poverty",3
"2016","West Bank and Gaza","Poverty gap at $6.85 a day (2017 PPP) (%)","5.3","MARCH",23,0,"High Poverty",23
"2016","West Bank and Gaza","Poverty gap at $6.85 a day (2017 PPP) (%)","5.3","FEBRUARY",17,2,"High Poverty",19
"2016","West Bank and Gaza","Poverty gap at $6.85 a day (2017 PPP) (%)","5.3","JANUARY",20,2,"High Poverty",22
"2016","West Bank and Gaza","Poverty gap at $6.85 a day (2017 PPP) (%)","5.3","OCTOBER",8,2,"High Poverty",10
"2016","West Bank and Gaza","Poverty gap at $6.85 a day (2017 PPP) (%)","5.3","SEPTEMBER",11,0,"High Poverty",11
"2016","West Bank and Gaza","Income share held by second 20%","11.9","DECEMBER",5,0,"Medium Poverty",5
"2016","West Bank and Gaza","Income share held by second 20%","11.9","NOVEMBER",6,0,"Medium Poverty",6
"2016","West Bank and Gaza","Income share held by second 20%","11.9","AUGUST",3,0,"Medium Poverty",3
"2016","West Bank and Gaza","Income share held by second 20%","11.9","JULY",9,1,"Medium Poverty",10
"2016","West Bank and Gaza","Income share held by second 20%","11.9","JUNE",7,5,"Medium Poverty",12
"2016","West Bank and Gaza","Income share held by second 20%","11.9","MAY",3,0,"Medium Poverty",3
"2016","West Bank and Gaza","Income share held by second 20%","11.9","APRIL",3,0,"Medium Poverty",3
"2016","West Bank and Gaza","Income share held by second 20%","11.9","MARCH",23,0,"Medium Poverty",23
"2016","West Bank and Gaza","Income share held by second 20%","11.9","FEBRUARY",17,2,"Medium Poverty",19
"2016","West Bank and Gaza","Income share held by second 20%","11.9","JANUARY",20,2,"Medium Poverty",22
"2016","West Bank and Gaza","Income share held by second 20%","11.9","OCTOBER",8,2,"Medium Poverty",10
"2016","West Bank and Gaza","Income share held by second 20%","11.9","SEPTEMBER",11,0,"Medium Poverty",11
"2016","West Bank and Gaza","Multidimensional poverty index (scale 0-1)","0.102","DECEMBER",5,0,"Low Poverty",5
"2016","West Bank and Gaza","Multidimensional poverty index (scale 0-1)","0.102","NOVEMBER",6,0,"Low Poverty",6
"2016","West Bank and Gaza","Multidimensional poverty index (scale 0-1)","0.102","AUGUST",3,0,"Low Poverty",3
"2016","West Bank and Gaza","Multidimensional poverty index (scale 0-1)","0.102","JULY",9,1,"Low Poverty",10
"2016","West Bank and Gaza","Multidimensional poverty index (scale 0-1)","0.102","JUNE",7,5,"Low Poverty",12
"2016","West Bank and Gaza","Multidimensional poverty index (scale 0-1)","0.102","MAY",3,0,"Low Poverty",3
"2016","West Bank and Gaza","Multidimensional poverty index (scale 0-1)","0.102","APRIL",3,0,"Low Poverty",3
"2016","West Bank and Gaza","Multidimensional poverty index (scale 0-1)","0.102","MARCH",23,0,"Low Poverty",23
"2016","West Bank and Gaza","Multidimensional poverty index (scale 0-1)","0.102","FEBRUARY",17,2,"Low Poverty",19
"2016","West Bank and Gaza","Multidimensional poverty index (scale 0-1)","0.102","JANUARY",20,2,"Low Poverty",22
"2016","West Bank and Gaza","Multidimensional poverty index (scale 0-1)","0.102","OCTOBER",8,2,"Low Poverty",10
"2016","West Bank and Gaza","Multidimensional poverty index (scale 0-1)","0.102","SEPTEMBER",11,0,"Low Poverty",11
"2016","West Bank and Gaza","Poverty headcount ratio at national poverty lines (% of population)","29.2","DECEMBER",5,0,"High Poverty",5
"2016","West Bank and Gaza","Poverty headcount ratio at national poverty lines (% of population)","29.2","NOVEMBER",6,0,"High Poverty",6
"2016","West Bank and Gaza","Poverty headcount ratio at national poverty lines (% of population)","29.2","AUGUST",3,0,"High Poverty",3
"2016","West Bank and Gaza","Poverty headcount ratio at national poverty lines (% of population)","29.2","JULY",9,1,"High Poverty",10
"2016","West Bank and Gaza","Poverty headcount ratio at national poverty lines (% of population)","29.2","JUNE",7,5,"High Poverty",12
"2016","West Bank and Gaza","Poverty headcount ratio at national poverty lines (% of population)","29.2","MAY",3,0,"High Poverty",3
"2016","West Bank and Gaza","Poverty headcount ratio at national poverty lines (% of population)","29.2","APRIL",3,0,"High Poverty",3
"2016","West Bank and Gaza","Poverty headcount ratio at national poverty lines (% of population)","29.2","MARCH",23,0,"High Poverty",23
"2016","West Bank and Gaza","Poverty headcount ratio at national poverty lines (% of population)","29.2","FEBRUARY",17,2,"High Poverty",19
"2016","West Bank and Gaza","Poverty headcount ratio at national poverty lines (% of population)","29.2","JANUARY",20,2,"High Poverty",22
"2016","West Bank and Gaza","Poverty headcount ratio at national poverty lines (% of population)","29.2","OCTOBER",8,2,"High Poverty",10
"2016","West Bank and Gaza","Poverty headcount ratio at national poverty lines (% of population)","29.2","SEPTEMBER",11,0,"High Poverty",11
"2016","West Bank and Gaza","Income share held by fourth 20%","23.2","DECEMBER",5,0,"High Poverty",5
"2016","West Bank and Gaza","Income share held by fourth 20%","23.2","NOVEMBER",6,0,"High Poverty",6
"2016","West Bank and Gaza","Income share held by fourth 20%","23.2","AUGUST",3,0,"High Poverty",3
"2016","West Bank and Gaza","Income share held by fourth 20%","23.2","JULY",9,1,"High Poverty",10
"2016","West Bank and Gaza","Income share held by fourth 20%","23.2","JUNE",7,5,"High Poverty",12
"2016","West Bank and Gaza","Income share held by fourth 20%","23.2","MAY",3,0,"High Poverty",3
"2016","West Bank and Gaza","Income share held by fourth 20%","23.2","APRIL",3,0,"High Poverty",3
"2016","West Bank and Gaza","Income share held by fourth 20%","23.2","MARCH",23,0,"High Poverty",23
"2016","West Bank and Gaza","Income share held by fourth 20%","23.2","FEBRUARY",17,2,"High Poverty",19
"2016","West Bank and Gaza","Income share held by fourth 20%","23.2","JANUARY",20,2,"High Poverty",22
"2016","West Bank and Gaza","Income share held by fourth 20%","23.2","OCTOBER",8,2,"High Poverty",10
"2016","West Bank and Gaza","Income share held by fourth 20%","23.2","SEPTEMBER",11,0,"High Poverty",11
"2016","West Bank and Gaza","Income share held by lowest 20%","7.3","DECEMBER",5,0,"High Poverty",5
"2016","West Bank and Gaza","Income share held by lowest 20%","7.3","NOVEMBER",6,0,"High Poverty",6
"2016","West Bank and Gaza","Income share held by lowest 20%","7.3","AUGUST",3,0,"High Poverty",3
"2016","West Bank and Gaza","Income share held by lowest 20%","7.3","JULY",9,1,"High Poverty",10
"2016","West Bank and Gaza","Income share held by lowest 20%","7.3","JUNE",7,5,"High Poverty",12
"2016","West Bank and Gaza","Income share held by lowest 20%","7.3","MAY",3,0,"High Poverty",3
"2016","West Bank and Gaza","Income share held by lowest 20%","7.3","APRIL",3,0,"High Poverty",3
"2016","West Bank and Gaza","Income share held by lowest 20%","7.3","MARCH",23,0,"High Poverty",23
"2016","West Bank and Gaza","Income share held by lowest 20%","7.3","FEBRUARY",17,2,"High Poverty",19
"2016","West Bank and Gaza","Income share held by lowest 20%","7.3","JANUARY",20,2,"High Poverty",22
"2016","West Bank and Gaza","Income share held by lowest 20%","7.3","OCTOBER",8,2,"High Poverty",10
"2016","West Bank and Gaza","Income share held by lowest 20%","7.3","SEPTEMBER",11,0,"High Poverty",11
"2016","West Bank and Gaza","Poverty headcount ratio at $6.85 a day (2017 PPP) (% of population)","20.5","DECEMBER",5,0,"High Poverty",5
"2016","West Bank and Gaza","Poverty headcount ratio at $6.85 a day (2017 PPP) (% of population)","20.5","NOVEMBER",6,0,"High Poverty",6
"2016","West Bank and Gaza","Poverty headcount ratio at $6.85 a day (2017 PPP) (% of population)","20.5","AUGUST",3,0,"High Poverty",3
"2016","West Bank and Gaza","Poverty headcount ratio at $6.85 a day (2017 PPP) (% of population)","20.5","JULY",9,1,"High Poverty",10
"2016","West Bank and Gaza","Poverty headcount ratio at $6.85 a day (2017 PPP) (% of population)","20.5","JUNE",7,5,"High Poverty",12
"2016","West Bank and Gaza","Poverty headcount ratio at $6.85 a day (2017 PPP) (% of population)","20.5","MAY",3,0,"High Poverty",3
"2016","West Bank and Gaza","Poverty headcount ratio at $6.85 a day (2017 PPP) (% of population)","20.5","APRIL",3,0,"High Poverty",3
"2016","West Bank and Gaza","Poverty headcount ratio at $6.85 a day (2017 PPP) (% of population)","20.5","MARCH",23,0,"High Poverty",23
"2016","West Bank and Gaza","Poverty headcount ratio at $6.85 a day (2017 PPP) (% of population)","20.5","FEBRUARY",17,2,"High Poverty",19
"2016","West Bank and Gaza","Poverty headcount ratio at $6.85 a day (2017 PPP) (% of population)","20.5","JANUARY",20,2,"High Poverty",22
"2016","West Bank and Gaza","Poverty headcount ratio at $6.85 a day (2017 PPP) (% of population)","20.5","OCTOBER",8,2,"High Poverty",10
"2016","West Bank and Gaza","Poverty headcount ratio at $6.85 a day (2017 PPP) (% of population)","20.5","SEPTEMBER",11,0,"High Poverty",11
"2016","West Bank and Gaza","Poverty headcount ratio at $3.65 a day (2017 PPP) (% of population)","3.1","DECEMBER",5,0,"High Poverty",5
"2016","West Bank and Gaza","Poverty headcount ratio at $3.65 a day (2017 PPP) (% of population)","3.1","NOVEMBER",6,0,"High Poverty",6
"2016","West Bank and Gaza","Poverty headcount ratio at $3.65 a day (2017 PPP) (% of population)","3.1","AUGUST",3,0,"High Poverty",3
"2016","West Bank and Gaza","Poverty headcount ratio at $3.65 a day (2017 PPP) (% of population)","3.1","JULY",9,1,"High Poverty",10
"2016","West Bank and Gaza","Poverty headcount ratio at $3.65 a day (2017 PPP) (% of population)","3.1","JUNE",7,5,"High Poverty",12
"2016","West Bank and Gaza","Poverty headcount ratio at $3.65 a day (2017 PPP) (% of population)","3.1","MAY",3,0,"High Poverty",3
"2016","West Bank and Gaza","Poverty headcount ratio at $3.65 a day (2017 PPP) (% of population)","3.1","APRIL",3,0,"High Poverty",3
"2016","West Bank and Gaza","Poverty headcount ratio at $3.65 a day (2017 PPP) (% of population)","3.1","MARCH",23,0,"High Poverty",23
"2016","West Bank and Gaza","Poverty headcount ratio at $3.65 a day (2017 PPP) (% of population)","3.1","FEBRUARY",17,2,"High Poverty",19
"2016","West Bank and Gaza","Poverty headcount ratio at $3.65 a day (2017 PPP) (% of population)","3.1","JANUARY",20,2,"High Poverty",22
"2016","West Bank and Gaza","Poverty headcount ratio at $3.65 a day (2017 PPP) (% of population)","3.1","OCTOBER",8,2,"High Poverty",10
"2016","West Bank and Gaza","Poverty headcount ratio at $3.65 a day (2017 PPP) (% of population)","3.1","SEPTEMBER",11,0,"High Poverty",11
"2016","West Bank and Gaza","Poverty gap at $2.15 a day (2017 PPP) (%)","0.1","DECEMBER",5,0,"Low Poverty",5
"2016","West Bank and Gaza","Poverty gap at $2.15 a day (2017 PPP) (%)","0.1","NOVEMBER",6,0,"Low Poverty",6
"2016","West Bank and Gaza","Poverty gap at $2.15 a day (2017 PPP) (%)","0.1","AUGUST",3,0,"Low Poverty",3
"2016","West Bank and Gaza","Poverty gap at $2.15 a day (2017 PPP) (%)","0.1","JULY",9,1,"Low Poverty",10
"2016","West Bank and Gaza","Poverty gap at $2.15 a day (2017 PPP) (%)","0.1","JUNE",7,5,"Low Poverty",12
"2016","West Bank and Gaza","Poverty gap at $2.15 a day (2017 PPP) (%)","0.1","MAY",3,0,"Low Poverty",3
"2016","West Bank and Gaza","Poverty gap at $2.15 a day (2017 PPP) (%)","0.1","APRIL",3,0,"Low Poverty",3
"2016","West Bank and Gaza","Poverty gap at $2.15 a day (2017 PPP) (%)","0.1","MARCH",23,0,"Low Poverty",23
"2016","West Bank and Gaza","Poverty gap at $2.15 a day (2017 PPP) (%)","0.1","FEBRUARY",17,2,"Low Poverty",19
"2016","West Bank and Gaza","Poverty gap at $2.15 a day (2017 PPP) (%)","0.1","JANUARY",20,2,"Low Poverty",22
"2016","West Bank and Gaza","Poverty gap at $2.15 a day (2017 PPP) (%)","0.1","OCTOBER",8,2,"Low Poverty",10
"2016","West Bank and Gaza","Poverty gap at $2.15 a day (2017 PPP) (%)","0.1","SEPTEMBER",11,0,"Low Poverty",11
"2016","West Bank and Gaza","Annualized average growth rate in per capita real survey mean consumption or income, total population (%)","-0.55","DECEMBER",5,0,"Low Poverty",5
"2016","West Bank and Gaza","Annualized average growth rate in per capita real survey mean consumption or income, total population (%)","-0.55","NOVEMBER",6,0,"Low Poverty",6
"2016","West Bank and Gaza","Annualized average growth rate in per capita real survey mean consumption or income, total population (%)","-0.55","AUGUST",3,0,"Low Poverty",3
"2016","West Bank and Gaza","Annualized average growth rate in per capita real survey mean consumption or income, total population (%)","-0.55","JULY",9,1,"Low Poverty",10
"2016","West Bank and Gaza","Annualized average growth rate in per capita real survey mean consumption or income, total population (%)","-0.55","JUNE",7,5,"Low Poverty",12
"2016","West Bank and Gaza","Annualized average growth rate in per capita real survey mean consumption or income, total population (%)","-0.55","MAY",3,0,"Low Poverty",3
"2016","West Bank and Gaza","Annualized average growth rate in per capita real survey mean consumption or income, total population (%)","-0.55","APRIL",3,0,"Low Poverty",3
"2016","West Bank and Gaza","Annualized average growth rate in per capita real survey mean consumption or income, total population (%)","-0.55","MARCH",23,0,"Low Poverty",23
"2016","West Bank and Gaza","Annualized average growth rate in per capita real survey mean consumption or income, total population (%)","-0.55","FEBRUARY",17,2,"Low Poverty",19
"2016","West Bank and Gaza","Annualized average growth rate in per capita real survey mean consumption or income, total population (%)","-0.55","JANUARY",20,2,"Low Poverty",22
"2016","West Bank and Gaza","Annualized average growth rate in per capita real survey mean consumption or income, total population (%)","-0.55","OCTOBER",8,2,"Low Poverty",10
"2016","West Bank and Gaza","Annualized average growth rate in per capita real survey mean consumption or income, total population (%)","-0.55","SEPTEMBER",11,0,"Low Poverty",11
"2016","West Bank and Gaza","Income share held by lowest 10%","2.9","DECEMBER",5,0,"Medium Poverty",5
"2016","West Bank and Gaza","Income share held by lowest 10%","2.9","NOVEMBER",6,0,"Medium Poverty",6
"2016","West Bank and Gaza","Income share held by lowest 10%","2.9","AUGUST",3,0,"Medium Poverty",3
"2016","West Bank and Gaza","Income share held by lowest 10%","2.9","JULY",9,1,"Medium Poverty",10
"2016","West Bank and Gaza","Income share held by lowest 10%","2.9","JUNE",7,5,"Medium Poverty",12
"2016","West Bank and Gaza","Income share held by lowest 10%","2.9","MAY",3,0,"Medium Poverty",3
"2016","West Bank and Gaza","Income share held by lowest 10%","2.9","APRIL",3,0,"Medium Poverty",3
"2016","West Bank and Gaza","Income share held by lowest 10%","2.9","MARCH",23,0,"Medium Poverty",23
"2016","West Bank and Gaza","Income share held by lowest 10%","2.9","FEBRUARY",17,2,"Medium Poverty",19
"2016","West Bank and Gaza","Income share held by lowest 10%","2.9","JANUARY",20,2,"Medium Poverty",22
"2016","West Bank and Gaza","Income share held by lowest 10%","2.9","OCTOBER",8,2,"Medium Poverty",10
"2016","West Bank and Gaza","Income share held by lowest 10%","2.9","SEPTEMBER",11,0,"Medium Poverty",11
"2016","West Bank and Gaza","Proportion of people living below 50 percent of median income (%)","12.8","DECEMBER",5,0,"Medium Poverty",5
"2016","West Bank and Gaza","Proportion of people living below 50 percent of median income (%)","12.8","NOVEMBER",6,0,"Medium Poverty",6
"2016","West Bank and Gaza","Proportion of people living below 50 percent of median income (%)","12.8","AUGUST",3,0,"Medium Poverty",3
"2016","West Bank and Gaza","Proportion of people living below 50 percent of median income (%)","12.8","JULY",9,1,"Medium Poverty",10
"2016","West Bank and Gaza","Proportion of people living below 50 percent of median income (%)","12.8","JUNE",7,5,"Medium Poverty",12
"2016","West Bank and Gaza","Proportion of people living below 50 percent of median income (%)","12.8","MAY",3,0,"Medium Poverty",3
"2016","West Bank and Gaza","Proportion of people living below 50 percent of median income (%)","12.8","APRIL",3,0,"Medium Poverty",3
"2016","West Bank and Gaza","Proportion of people living below 50 percent of median income (%)","12.8","MARCH",23,0,"Medium Poverty",23
"2016","West Bank and Gaza","Proportion of people living below 50 percent of median income (%)","12.8","FEBRUARY",17,2,"Medium Poverty",19
"2016","West Bank and Gaza","Proportion of people living below 50 percent of median income (%)","12.8","JANUARY",20,2,"Medium Poverty",22
"2016","West Bank and Gaza","Proportion of people living below 50 percent of median income (%)","12.8","OCTOBER",8,2,"Medium Poverty",10
"2016","West Bank and Gaza","Proportion of people living below 50 percent of median income (%)","12.8","SEPTEMBER",11,0,"Medium Poverty",11
"2016","West Bank and Gaza","Gini index","33.7","DECEMBER",5,0,"High Poverty",5
"2016","West Bank and Gaza","Gini index","33.7","NOVEMBER",6,0,"High Poverty",6
"2016","West Bank and Gaza","Gini index","33.7","AUGUST",3,0,"High Poverty",3
"2016","West Bank and Gaza","Gini index","33.7","JULY",9,1,"High Poverty",10
"2016","West Bank and Gaza","Gini index","33.7","JUNE",7,5,"High Poverty",12
"2016","West Bank and Gaza","Gini index","33.7","MAY",3,0,"High Poverty",3
"2016","West Bank and Gaza","Gini index","33.7","APRIL",3,0,"High Poverty",3
"2016","West Bank and Gaza","Gini index","33.7","MARCH",23,0,"High Poverty",23
"2016","West Bank and Gaza","Gini index","33.7","FEBRUARY",17,2,"High Poverty",19
"2016","West Bank and Gaza","Gini index","33.7","JANUARY",20,2,"High Poverty",22
"2016","West Bank and Gaza","Gini index","33.7","OCTOBER",8,2,"High Poverty",10
"2016","West Bank and Gaza","Gini index","33.7","SEPTEMBER",11,0,"High Poverty",11
"2016","West Bank and Gaza","Multidimensional poverty intensity (average share of deprivations experienced by the poor)","42.4","DECEMBER",5,0,"High Poverty",5
"2016","West Bank and Gaza","Multidimensional poverty intensity (average share of deprivations experienced by the poor)","42.4","NOVEMBER",6,0,"High Poverty",6
"2016","West Bank and Gaza","Multidimensional poverty intensity (average share of deprivations experienced by the poor)","42.4","AUGUST",3,0,"High Poverty",3
"2016","West Bank and Gaza","Multidimensional poverty intensity (average share of deprivations experienced by the poor)","42.4","JULY",9,1,"High Poverty",10
"2016","West Bank and Gaza","Multidimensional poverty intensity (average share of deprivations experienced by the poor)","42.4","JUNE",7,5,"High Poverty",12
"2016","West Bank and Gaza","Multidimensional poverty intensity (average share of deprivations experienced by the poor)","42.4","MAY",3,0,"High Poverty",3
"2016","West Bank and Gaza","Multidimensional poverty intensity (average share of deprivations experienced by the poor)","42.4","APRIL",3,0,"High Poverty",3
"2016","West Bank and Gaza","Multidimensional poverty intensity (average share of deprivations experienced by the poor)","42.4","MARCH",23,0,"High Poverty",23
"2016","West Bank and Gaza","Multidimensional poverty intensity (average share of deprivations experienced by the poor)","42.4","FEBRUARY",17,2,"High Poverty",19
"2016","West Bank and Gaza","Multidimensional poverty intensity (average share of deprivations experienced by the poor)","42.4","JANUARY",20,2,"High Poverty",22
"2016","West Bank and Gaza","Multidimensional poverty intensity (average share of deprivations experienced by the poor)","42.4","OCTOBER",8,2,"High Poverty",10
"2016","West Bank and Gaza","Multidimensional poverty intensity (average share of deprivations experienced by the poor)","42.4","SEPTEMBER",11,0,"High Poverty",11
"2016","West Bank and Gaza","Poverty gap at $3.65 a day (2017 PPP) (%)","0.7","DECEMBER",5,0,"Low Poverty",5
"2016","West Bank and Gaza","Poverty gap at $3.65 a day (2017 PPP) (%)","0.7","NOVEMBER",6,0,"Low Poverty",6
"2016","West Bank and Gaza","Poverty gap at $3.65 a day (2017 PPP) (%)","0.7","AUGUST",3,0,"Low Poverty",3
"2016","West Bank and Gaza","Poverty gap at $3.65 a day (2017 PPP) (%)","0.7","JULY",9,1,"Low Poverty",10
"2016","West Bank and Gaza","Poverty gap at $3.65 a day (2017 PPP) (%)","0.7","JUNE",7,5,"Low Poverty",12
"2016","West Bank and Gaza","Poverty gap at $3.65 a day (2017 PPP) (%)","0.7","MAY",3,0,"Low Poverty",3
"2016","West Bank and Gaza","Poverty gap at $3.65 a day (2017 PPP) (%)","0.7","APRIL",3,0,"Low Poverty",3
"2016","West Bank and Gaza","Poverty gap at $3.65 a day (2017 PPP) (%)","0.7","MARCH",23,0,"Low Poverty",23
"2016","West Bank and Gaza","Poverty gap at $3.65 a day (2017 PPP) (%)","0.7","FEBRUARY",17,2,"Low Poverty",19
"2016","West Bank and Gaza","Poverty gap at $3.65 a day (2017 PPP) (%)","0.7","JANUARY",20,2,"Low Poverty",22
"2016","West Bank and Gaza","Poverty gap at $3.65 a day (2017 PPP) (%)","0.7","OCTOBER",8,2,"Low Poverty",10
"2016","West Bank and Gaza","Poverty gap at $3.65 a day (2017 PPP) (%)","0.7","SEPTEMBER",11,0,"Low Poverty",11
"2016","West Bank and Gaza","Multidimensional poverty headcount ratio, household (% of total households)","18.4","DECEMBER",5,0,"Medium Poverty",5
"2016","West Bank and Gaza","Multidimensional poverty headcount ratio, household (% of total households)","18.4","NOVEMBER",6,0,"Medium Poverty",6
"2016","West Bank and Gaza","Multidimensional poverty headcount ratio, household (% of total households)","18.4","AUGUST",3,0,"Medium Poverty",3
"2016","West Bank and Gaza","Multidimensional poverty headcount ratio, household (% of total households)","18.4","JULY",9,1,"Medium Poverty",10
"2016","West Bank and Gaza","Multidimensional poverty headcount ratio, household (% of total households)","18.4","JUNE",7,5,"Medium Poverty",12
"2016","West Bank and Gaza","Multidimensional poverty headcount ratio, household (% of total households)","18.4","MAY",3,0,"Medium Poverty",3
"2016","West Bank and Gaza","Multidimensional poverty headcount ratio, household (% of total households)","18.4","APRIL",3,0,"Medium Poverty",3
"2016","West Bank and Gaza","Multidimensional poverty headcount ratio, household (% of total households)","18.4","MARCH",23,0,"Medium Poverty",23
"2016","West Bank and Gaza","Multidimensional poverty headcount ratio, household (% of total households)","18.4","FEBRUARY",17,2,"Medium Poverty",19
"2016","West Bank and Gaza","Multidimensional poverty headcount ratio, household (% of total households)","18.4","JANUARY",20,2,"Medium Poverty",22
"2016","West Bank and Gaza","Multidimensional poverty headcount ratio, household (% of total households)","18.4","OCTOBER",8,2,"Medium Poverty",10
"2016","West Bank and Gaza","Multidimensional poverty headcount ratio, household (% of total households)","18.4","SEPTEMBER",11,0,"Medium Poverty",11
"2016","West Bank and Gaza","Multidimensional poverty headcount ratio (% of total population)","24","DECEMBER",5,0,"High Poverty",5
"2016","West Bank and Gaza","Multidimensional poverty headcount ratio (% of total population)","24","NOVEMBER",6,0,"High Poverty",6
"2016","West Bank and Gaza","Multidimensional poverty headcount ratio (% of total population)","24","AUGUST",3,0,"High Poverty",3
"2016","West Bank and Gaza","Multidimensional poverty headcount ratio (% of total population)","24","JULY",9,1,"High Poverty",10
"2016","West Bank and Gaza","Multidimensional poverty headcount ratio (% of total population)","24","JUNE",7,5,"High Poverty",12
"2016","West Bank and Gaza","Multidimensional poverty headcount ratio (% of total population)","24","MAY",3,0,"High Poverty",3
"2016","West Bank and Gaza","Multidimensional poverty headcount ratio (% of total population)","24","APRIL",3,0,"High Poverty",3
"2016","West Bank and Gaza","Multidimensional poverty headcount ratio (% of total population)","24","MARCH",23,0,"High Poverty",23
"2016","West Bank and Gaza","Multidimensional poverty headcount ratio (% of total population)","24","FEBRUARY",17,2,"High Poverty",19
"2016","West Bank and Gaza","Multidimensional poverty headcount ratio (% of total population)","24","JANUARY",20,2,"High Poverty",22
"2016","West Bank and Gaza","Multidimensional poverty headcount ratio (% of total population)","24","OCTOBER",8,2,"High Poverty",10
"2016","West Bank and Gaza","Multidimensional poverty headcount ratio (% of total population)","24","SEPTEMBER",11,0,"High Poverty",11
"2016","West Bank and Gaza","Poverty headcount ratio at $2.15 a day (2017 PPP) (% of population)","0.5","DECEMBER",5,0,"Low Poverty",5
"2016","West Bank and Gaza","Poverty headcount ratio at $2.15 a day (2017 PPP) (% of population)","0.5","NOVEMBER",6,0,"Low Poverty",6
"2016","West Bank and Gaza","Poverty headcount ratio at $2.15 a day (2017 PPP) (% of population)","0.5","AUGUST",3,0,"Low Poverty",3
"2016","West Bank and Gaza","Poverty headcount ratio at $2.15 a day (2017 PPP) (% of population)","0.5","JULY",9,1,"Low Poverty",10
"2016","West Bank and Gaza","Poverty headcount ratio at $2.15 a day (2017 PPP) (% of population)","0.5","JUNE",7,5,"Low Poverty",12
"2016","West Bank and Gaza","Poverty headcount ratio at $2.15 a day (2017 PPP) (% of population)","0.5","MAY",3,0,"Low Poverty",3
"2016","West Bank and Gaza","Poverty headcount ratio at $2.15 a day (2017 PPP) (% of population)","0.5","APRIL",3,0,"Low Poverty",3
"2016","West Bank and Gaza","Poverty headcount ratio at $2.15 a day (2017 PPP) (% of population)","0.5","MARCH",23,0,"Low Poverty",23
"2016","West Bank and Gaza","Poverty headcount ratio at $2.15 a day (2017 PPP) (% of population)","0.5","FEBRUARY",17,2,"Low Poverty",19
"2016","West Bank and Gaza","Poverty headcount ratio at $2.15 a day (2017 PPP) (% of population)","0.5","JANUARY",20,2,"Low Poverty",22
"2016","West Bank and Gaza","Poverty headcount ratio at $2.15 a day (2017 PPP) (% of population)","0.5","OCTOBER",8,2,"Low Poverty",10
"2016","West Bank and Gaza","Poverty headcount ratio at $2.15 a day (2017 PPP) (% of population)","0.5","SEPTEMBER",11,0,"Low Poverty",11
"2018","West Bank and Gaza","Population living in slums (% of urban population)","19.5","SEPTEMBER",25,1,"Medium Poverty",26
"2018","West Bank and Gaza","Population living in slums (% of urban population)","19.5","OCTOBER",32,2,"Medium Poverty",34
"2018","West Bank and Gaza","Population living in slums (% of urban population)","19.5","FEBRUARY",9,1,"Medium Poverty",10
"2018","West Bank and Gaza","Population living in slums (% of urban population)","19.5","JANUARY",7,1,"Medium Poverty",8
"2018","West Bank and Gaza","Population living in slums (% of urban population)","19.5","APRIL",34,0,"Medium Poverty",34
"2018","West Bank and Gaza","Population living in slums (% of urban population)","19.5","MARCH",20,3,"Medium Poverty",23
"2018","West Bank and Gaza","Population living in slums (% of urban population)","19.5","DECEMBER",14,2,"Medium Poverty",16
"2018","West Bank and Gaza","Population living in slums (% of urban population)","19.5","NOVEMBER",25,1,"Medium Poverty",26
"2018","West Bank and Gaza","Population living in slums (% of urban population)","19.5","JUNE",18,0,"Medium Poverty",18
"2018","West Bank and Gaza","Population living in slums (% of urban population)","19.5","MAY",66,1,"Medium Poverty",67
"2018","West Bank and Gaza","Population living in slums (% of urban population)","19.5","AUGUST",16,0,"Medium Poverty",16
"2018","West Bank and Gaza","Population living in slums (% of urban population)","19.5","JULY",24,2,"Medium Poverty",26
"2020","West Bank and Gaza","Population living in slums (% of urban population)","19.5","MARCH",2,0,"Medium Poverty",2
"2020","West Bank and Gaza","Population living in slums (% of urban population)","19.5","APRIL",1,0,"Medium Poverty",1
"2020","West Bank and Gaza","Population living in slums (% of urban population)","19.5","SEPTEMBER",1,0,"Medium Poverty",1
"2020","West Bank and Gaza","Population living in slums (% of urban population)","19.5","FEBRUARY",9,0,"Medium Poverty",9
"2020","West Bank and Gaza","Population living in slums (% of urban population)","19.5","JANUARY",6,0,"Medium Poverty",6
"2020","West Bank and Gaza","Population living in slums (% of urban population)","19.5","OCTOBER",2,0,"Medium Poverty",2
"2020","West Bank and Gaza","Population living in slums (% of urban population)","19.5","JUNE",1,0,"Medium Poverty",1
"2020","West Bank and Gaza","Population living in slums (% of urban population)","19.5","MAY",4,1,"Medium Poverty",5
"2020","West Bank and Gaza","Population living in slums (% of urban population)","19.5","AUGUST",3,1,"Medium Poverty",4
"2020","West Bank and Gaza","Population living in slums (% of urban population)","19.5","JULY",1,0,"Medium Poverty",1
"2020","West Bank and Gaza","Population living in slums (% of urban population)","19.5","DECEMBER",2,1,"Medium Poverty",3
"2020","West Bank and Gaza","Population living in slums (% of urban population)","19.5","NOVEMBER",2,0,"Medium Poverty",2
